"date","geography","geography code","Rural Urban","Variable: All usual residents; measures: Value","Variable: Males; measures: Value","Variable: Females; measures: Value","Variable: Lives in a household; measures: Value","Variable: Lives in a communal establishment; measures: Value","Variable: Schoolchild or full-time student aged 4 and over at their non term-time address; measures: Value","Variable: Area (Hectares); measures: Value","Variable: Density (number of persons per hectare); measures: Value"
"2011","Darlington 001","E02002559","Total",8842,4364,4478,8828,14,130,13247.01,0.7
"2011","Darlington 002","E02002560","Total",5997,2987,3010,5994,3,51,206.03,29.1
"2011","Darlington 003","E02002561","Total",5741,2781,2960,5709,32,87,146.95,39.1
"2011","Darlington 004","E02002562","Total",6066,3001,3065,5973,93,38,124.22,48.8
"2011","Darlington 005","E02002563","Total",5463,2606,2857,5286,177,38,156.19,35.0
"2011","Darlington 006","E02002564","Total",9502,4571,4931,9489,13,97,196.40,48.4
"2011","Darlington 007","E02002565","Total",5450,2601,2849,5412,38,48,68.53,79.5
"2011","Darlington 008","E02002566","Total",6918,3613,3305,6757,161,66,176.19,39.3
"2011","Darlington 009","E02002567","Total",7254,3479,3775,7157,97,41,410.83,17.7
"2011","Darlington 010","E02002568","Total",5905,2857,3048,5791,114,156,155.56,38.0
"2011","Darlington 011","E02002569","Total",9095,4324,4771,8968,127,202,505.95,18.0
"2011","Darlington 012","E02002570","Total",8213,4005,4208,7945,268,43,127.24,64.5
"2011","Darlington 013","E02002571","Total",6516,3181,3335,6478,38,40,197.47,33.0
"2011","Darlington 014","E02002572","Total",6312,3074,3238,6246,66,56,151.18,41.8
"2011","Darlington 015","E02002573","Total",8290,4039,4251,8078,212,125,3877.76,2.1
"2011","County Durham 002","E02004290","Total",5981,2951,3030,5981,0,59,883.62,6.8
"2011","County Durham 005","E02004291","Total",6787,3286,3501,6702,85,35,787.07,8.6
"2011","County Durham 007","E02004292","Total",7916,3824,4092,7916,0,62,661.64,12.0
"2011","County Durham 011","E02004293","Total",9379,4476,4903,9278,101,67,451.88,20.8
"2011","County Durham 013","E02004294","Total",8484,4145,4339,8421,63,126,355.43,23.9
"2011","County Durham 015","E02004295","Total",7537,3564,3973,7459,78,73,1617.25,4.7
"2011","County Durham 019","E02004296","Total",8033,3996,4037,7936,97,64,2001.26,4.0
"2011","County Durham 001","E02004297","Total",7900,3918,3982,7825,75,71,1558.11,5.1
"2011","County Durham 003","E02004298","Total",9703,4757,4946,9486,217,122,1877.56,5.2
"2011","County Durham 004","E02004299","Total",8474,4169,4305,8352,122,69,898.31,9.4
"2011","County Durham 006","E02004300","Total",7686,3720,3966,7663,23,48,1194.66,6.4
"2011","County Durham 008","E02004301","Total",8894,4343,4551,8770,124,27,492.74,18.1
"2011","County Durham 009","E02004302","Total",7747,3796,3951,7692,55,38,990.92,7.8
"2011","County Durham 010","E02004303","Total",11457,5714,5743,11304,153,92,616.93,18.6
"2011","County Durham 012","E02004304","Total",8892,4272,4620,8770,122,52,911.81,9.8
"2011","County Durham 014","E02004305","Total",8640,4195,4445,8607,33,74,6987.45,1.2
"2011","County Durham 020","E02004306","Total",5789,2839,2950,5785,4,81,6221.58,0.9
"2011","County Durham 024","E02004307","Total",6570,3154,3416,6458,112,60,5328.92,1.2
"2011","County Durham 022","E02004308","Total",7819,4136,3683,6763,1056,155,1145.23,6.8
"2011","County Durham 023","E02004309","Total",5902,2777,3125,5842,60,76,253.93,23.2
"2011","County Durham 026","E02004310","Total",7962,3874,4088,7895,67,88,2028.04,3.9
"2011","County Durham 027","E02004311","Total",9108,4416,4692,9072,36,80,3433.63,2.7
"2011","County Durham 028","E02004312","Total",7549,3639,3910,7492,57,89,569.28,13.3
"2011","County Durham 029","E02004313","Total",6684,3320,3364,6671,13,34,323.27,20.7
"2011","County Durham 030","E02004314","Total",12248,6354,5894,6044,6204,167,708.46,17.3
"2011","County Durham 033","E02004315","Total",10184,5118,5066,9750,434,264,1263.57,8.1
"2011","County Durham 031","E02004316","Total",5683,2794,2889,5683,0,33,1756.50,3.2
"2011","County Durham 038","E02004317","Total",7663,3710,3953,7590,73,72,2098.26,3.7
"2011","County Durham 041","E02004318","Total",6099,2950,3149,5968,131,93,2551.11,2.4
"2011","County Durham 044","E02004319","Total",7474,3704,3770,7456,18,59,2536.91,2.9
"2011","County Durham 016","E02004320","Total",8956,4412,4544,8858,98,45,1041.12,8.6
"2011","County Durham 017","E02004321","Total",8345,4150,4195,8192,153,37,323.49,25.8
"2011","County Durham 018","E02004322","Total",8490,3967,4523,8436,54,28,657.28,12.9
"2011","County Durham 021","E02004323","Total",7906,3981,3925,7802,104,37,1027.16,7.7
"2011","County Durham 025","E02004324","Total",5732,2888,2844,5732,0,32,2182.22,2.6
"2011","County Durham 032","E02004325","Total",8722,4199,4523,8532,190,57,500.85,17.4
"2011","County Durham 034","E02004326","Total",6190,3082,3108,6144,46,38,1893.51,3.3
"2011","County Durham 036","E02004327","Total",6374,3096,3278,6302,72,25,259.34,24.6
"2011","County Durham 035","E02004328","Total",7337,3482,3855,7336,1,46,216.00,34.0
"2011","County Durham 037","E02004329","Total",6772,3332,3440,6689,83,50,321.78,21.0
"2011","County Durham 039","E02004330","Total",5944,2887,3057,5904,40,36,808.62,7.4
"2011","County Durham 040","E02004331","Total",7085,3515,3570,6986,99,33,1256.68,5.6
"2011","County Durham 043","E02004332","Total",7278,3540,3738,7250,28,58,3967.60,1.8
"2011","County Durham 047","E02004333","Total",7181,3570,3611,7181,0,64,670.06,10.7
"2011","County Durham 048","E02004334","Total",7370,3586,3784,7351,19,58,2017.16,3.7
"2011","County Durham 049","E02004335","Total",6289,3031,3258,6268,21,50,652.65,9.6
"2011","County Durham 050","E02004336","Total",6876,3351,3525,6792,84,37,1086.24,6.3
"2011","County Durham 052","E02004337","Total",9106,4499,4607,9058,48,73,2090.52,4.4
"2011","County Durham 053","E02004338","Total",6761,3308,3453,6725,36,48,1857.63,3.6
"2011","County Durham 054","E02004339","Total",6879,3371,3508,6821,58,98,9473.55,0.7
"2011","County Durham 059","E02004340","Total",10363,5067,5296,10239,124,67,1438.64,7.2
"2011","County Durham 060","E02004341","Total",8417,4177,4240,8335,82,127,681.49,12.4
"2011","County Durham 061","E02004342","Total",5967,2870,3097,5839,128,48,148.50,40.2
"2011","County Durham 062","E02004343","Total",5527,2599,2928,5441,86,44,631.25,8.8
"2011","County Durham 063","E02004344","Total",7034,3347,3687,7034,0,68,988.86,7.1
"2011","County Durham 064","E02004345","Total",12759,6262,6497,12608,151,137,25078.57,0.5
"2011","County Durham 065","E02004346","Total",5241,2595,2646,5225,16,100,57620.88,0.1
"2011","County Durham 066","E02004347","Total",7040,3585,3455,6240,800,117,913.28,7.7
"2011","County Durham 042","E02004348","Total",8063,3967,4096,8016,47,131,39592.76,0.2
"2011","County Durham 045","E02004349","Total",9228,4525,4703,9189,39,62,2510.41,3.7
"2011","County Durham 046","E02004350","Total",9614,4720,4894,9489,125,85,2961.91,3.2
"2011","County Durham 051","E02004351","Total",7025,3453,3572,6909,116,48,1472.02,4.8
"2011","County Durham 055","E02004352","Total",7566,3722,3844,7405,161,68,1042.21,7.3
"2011","County Durham 056","E02004353","Total",7549,3560,3989,7431,118,93,246.12,30.7
"2011","County Durham 057","E02004354","Total",8755,4276,4479,8697,58,82,2261.08,3.9
"2011","County Durham 058","E02004355","Total",7257,3397,3860,7201,56,48,209.49,34.6
"2011","Hartlepool 001","E02002483","Total",9084,4361,4723,9084,0,69,276.10,32.9
"2011","Hartlepool 002","E02002484","Total",10316,5070,5246,10123,193,58,476.62,21.6
"2011","Hartlepool 003","E02002485","Total",7835,3773,4062,7793,42,31,179.50,43.6
"2011","Hartlepool 005","E02002487","Total",5357,2754,2603,5354,3,32,125.29,42.8
"2011","Hartlepool 006","E02002488","Total",6110,2960,3150,6028,82,112,174.05,35.1
"2011","Hartlepool 007","E02002489","Total",7927,3993,3934,7777,150,46,187.39,42.3
"2011","Hartlepool 008","E02002490","Total",6079,2927,3152,6057,22,35,175.39,34.7
"2011","Hartlepool 009","E02002491","Total",6559,3131,3428,6506,53,46,231.50,28.3
"2011","Hartlepool 010","E02002492","Total",6684,3176,3508,6573,111,42,448.00,14.9
"2011","Hartlepool 011","E02002493","Total",6458,3142,3316,6326,132,74,1233.78,5.2
"2011","Hartlepool 012","E02002494","Total",7750,3687,4063,7675,75,39,153.63,50.4
"2011","Hartlepool 014","E02006909","Total",11869,5777,6092,11795,74,196,5724.86,2.1
"2011","Middlesbrough 001","E02002496","Total",11646,6400,5246,10577,1069,105,575.12,20.2
"2011","Middlesbrough 002","E02002497","Total",6268,2978,3290,6268,0,23,171.51,36.5
"2011","Middlesbrough 003","E02002498","Total",8584,4593,3991,8583,1,52,113.07,75.9
"2011","Middlesbrough 004","E02002499","Total",7516,3374,4142,7432,84,20,186.62,40.3
"2011","Middlesbrough 005","E02002500","Total",5919,2922,2997,5787,132,51,106.71,55.5
"2011","Middlesbrough 006","E02002501","Total",5346,2606,2740,5260,86,21,118.22,45.2
"2011","Middlesbrough 007","E02002502","Total",9615,4700,4915,9559,56,24,226.78,42.4
"2011","Middlesbrough 008","E02002503","Total",6515,3096,3419,6503,12,26,243.12,26.8
"2011","Middlesbrough 009","E02002504","Total",9711,4837,4874,9625,86,116,167.60,57.9
"2011","Middlesbrough 010","E02002505","Total",6254,2836,3418,6224,30,20,119.41,52.4
"2011","Middlesbrough 011","E02002506","Total",5932,2833,3099,5613,319,21,207.92,28.5
"2011","Middlesbrough 012","E02002507","Total",6027,2927,3100,6021,6,77,202.76,29.7
"2011","Middlesbrough 013","E02002508","Total",5074,2429,2645,5071,3,41,264.53,19.2
"2011","Middlesbrough 014","E02002509","Total",5583,2708,2875,5543,40,45,126.64,44.1
"2011","Middlesbrough 015","E02002510","Total",5712,2743,2969,5712,0,40,328.78,17.4
"2011","Middlesbrough 017","E02002512","Total",5305,2585,2720,5265,40,62,238.17,22.3
"2011","Middlesbrough 018","E02002513","Total",8844,4215,4629,8745,99,52,645.06,13.7
"2011","Middlesbrough 019","E02002514","Total",8967,4290,4677,8826,141,78,408.61,21.9
"2011","Middlesbrough 020","E02006811","Total",9594,4660,4934,9542,52,166,936.84,10.2
"2011","Northumberland 004","E02005702","Total",6554,3235,3319,6170,384,107,15164.55,0.4
"2011","Northumberland 005","E02005703","Total",6766,3206,3560,6664,102,81,1744.83,3.9
"2011","Northumberland 006","E02005704","Total",12408,6039,6369,12338,70,160,10235.88,1.2
"2011","Northumberland 007","E02005705","Total",7509,3708,3801,7438,71,157,80805.60,0.1
"2011","Northumberland 001","E02005706","Total",9620,4560,5060,9340,280,83,566.92,17.0
"2011","Northumberland 002","E02005707","Total",6897,3364,3533,6809,88,117,20812.64,0.3
"2011","Northumberland 003","E02005708","Total",10450,5141,5309,10396,54,177,75800.87,0.1
"2011","Northumberland 022","E02005709","Total",6860,3276,3584,6671,189,20,231.92,29.6
"2011","Northumberland 023","E02005710","Total",8431,4164,4267,8309,122,51,213.98,39.4
"2011","Northumberland 024","E02005711","Total",8341,3999,4342,8296,45,30,172.26,48.4
"2011","Northumberland 025","E02005712","Total",7030,3433,3597,7010,20,35,999.77,7.0
"2011","Northumberland 026","E02005713","Total",6677,3300,3377,6677,0,46,294.55,22.7
"2011","Northumberland 027","E02005714","Total",5380,2646,2734,5380,0,83,132.13,40.7
"2011","Northumberland 029","E02005715","Total",8633,4077,4556,8442,191,50,1575.80,5.5
"2011","Northumberland 028","E02005716","Total",8783,4192,4591,8641,142,61,297.47,29.5
"2011","Northumberland 030","E02005717","Total",7805,3715,4090,7746,59,44,1472.78,5.3
"2011","Northumberland 031","E02005718","Total",6617,3231,3386,6617,0,54,281.61,23.5
"2011","Northumberland 032","E02005719","Total",7617,3784,3833,7604,13,31,1364.02,5.6
"2011","Northumberland 008","E02005720","Total",12092,6458,5634,10911,1181,109,7194.32,1.7
"2011","Northumberland 011","E02005721","Total",5180,2586,2594,4838,342,67,1817.23,2.9
"2011","Northumberland 015","E02005722","Total",7115,3488,3627,7070,45,168,36973.01,0.2
"2011","Northumberland 016","E02005723","Total",6281,2917,3364,6214,67,82,301.14,20.9
"2011","Northumberland 018","E02005724","Total",6146,3035,3111,6099,47,146,384.35,16.0
"2011","Northumberland 033","E02005725","Total",6516,3086,3430,6393,123,123,4432.69,1.5
"2011","Northumberland 034","E02005726","Total",7708,3912,3796,7539,169,188,10720.54,0.7
"2011","Northumberland 019","E02005727","Total",6398,3193,3205,6375,23,152,111715.91,0.1
"2011","Northumberland 037","E02005728","Total",7102,3519,3583,7028,74,112,38950.63,0.2
"2011","Northumberland 036","E02005729","Total",5620,2696,2924,5467,153,114,5339.92,1.1
"2011","Northumberland 035","E02005730","Total",13097,6224,6873,12757,340,286,3546.11,3.7
"2011","Northumberland 038","E02005731","Total",10853,5242,5611,10758,95,108,893.88,12.1
"2011","Northumberland 039","E02005732","Total",9052,4366,4686,8808,244,242,18438.59,0.5
"2011","Northumberland 040","E02005733","Total",8136,4031,4105,7994,142,202,41750.39,0.2
"2011","Northumberland 009","E02005734","Total",6308,3034,3274,6242,66,30,864.92,7.3
"2011","Northumberland 010","E02005735","Total",7940,3928,4012,7876,64,39,147.91,53.7
"2011","Northumberland 013","E02005736","Total",7555,3732,3823,7508,47,41,708.95,10.7
"2011","Northumberland 012","E02005737","Total",7227,3469,3758,7122,105,86,1288.78,5.6
"2011","Northumberland 014","E02005738","Total",5067,2477,2590,5067,0,38,213.22,23.8
"2011","Northumberland 017","E02005739","Total",9464,4535,4929,9403,61,66,973.51,9.7
"2011","Northumberland 020","E02005740","Total",10275,5024,5251,10175,100,52,1173.46,8.8
"2011","Northumberland 021","E02005741","Total",8518,4102,4416,8399,119,84,1304.79,6.5
"2011","Redcar and Cleveland 001","E02002515","Total",6810,3459,3351,6655,155,32,132.89,51.2
"2011","Redcar and Cleveland 002","E02002516","Total",5734,2791,2943,5711,23,51,131.37,43.6
"2011","Redcar and Cleveland 003","E02002517","Total",5380,2588,2792,5371,9,28,3355.70,1.6
"2011","Redcar and Cleveland 004","E02002518","Total",10723,5165,5558,10679,44,155,298.49,35.9
"2011","Redcar and Cleveland 005","E02002519","Total",7045,3313,3732,6915,130,38,155.79,45.2
"2011","Redcar and Cleveland 006","E02002520","Total",13176,6416,6760,13146,30,123,1234.47,10.7
"2011","Redcar and Cleveland 007","E02002521","Total",5958,2872,3086,5717,241,64,307.54,19.4
"2011","Redcar and Cleveland 009","E02002523","Total",6514,3063,3451,6514,0,19,218.74,29.8
"2011","Redcar and Cleveland 010","E02002524","Total",5394,2669,2725,5374,20,34,772.52,7.0
"2011","Redcar and Cleveland 011","E02002525","Total",8357,4007,4350,8233,124,33,405.09,20.6
"2011","Redcar and Cleveland 012","E02002526","Total",7454,3622,3832,7442,12,74,1392.35,5.4
"2011","Redcar and Cleveland 013","E02002527","Total",5177,2569,2608,5095,82,14,408.94,12.7
"2011","Redcar and Cleveland 015","E02002529","Total",5736,2833,2903,5721,15,46,294.04,19.5
"2011","Redcar and Cleveland 016","E02002530","Total",6519,3289,3230,6493,26,36,7696.40,0.8
"2011","Redcar and Cleveland 018","E02002532","Total",6261,3014,3247,6166,95,53,2091.81,3.0
"2011","Redcar and Cleveland 019","E02002533","Total",5758,2788,2970,5693,65,87,208.05,27.7
"2011","Redcar and Cleveland 020","E02002534","Total",5758,2816,2942,5664,94,96,4366.45,1.3
"2011","Redcar and Cleveland 021","E02006812","Total",7353,3519,3834,7353,0,52,394.22,18.7
"2011","Redcar and Cleveland 022","E02006910","Total",10070,4862,5208,9987,83,61,624.65,16.1
"2011","Stockton-on-Tees 001","E02002535","Total",10032,4902,5130,9938,94,127,346.33,29.0
"2011","Stockton-on-Tees 002","E02002536","Total",9595,4561,5034,9581,14,61,210.66,45.5
"2011","Stockton-on-Tees 003","E02002537","Total",9013,4326,4687,8944,69,58,2704.19,3.3
"2011","Stockton-on-Tees 004","E02002538","Total",5989,2941,3048,5896,93,46,626.97,9.6
"2011","Stockton-on-Tees 005","E02002539","Total",8793,4310,4483,8704,89,157,8030.16,1.1
"2011","Stockton-on-Tees 006","E02002540","Total",6286,3027,3259,6286,0,81,247.45,25.4
"2011","Stockton-on-Tees 007","E02002541","Total",6301,3148,3153,6281,20,59,181.53,34.7
"2011","Stockton-on-Tees 008","E02002542","Total",8341,4003,4338,8314,27,29,200.50,41.6
"2011","Stockton-on-Tees 009","E02002543","Total",8255,3917,4338,8169,86,40,239.68,34.4
"2011","Stockton-on-Tees 010","E02002544","Total",8594,4662,3932,7542,1052,43,294.04,29.2
"2011","Stockton-on-Tees 011","E02002545","Total",5395,2641,2754,5392,3,53,238.57,22.6
"2011","Stockton-on-Tees 012","E02002546","Total",7739,3791,3948,7678,61,55,197.81,39.1
"2011","Stockton-on-Tees 013","E02002547","Total",6343,3045,3298,6320,23,75,189.41,33.5
"2011","Stockton-on-Tees 014","E02002548","Total",11233,5752,5481,10635,598,90,803.65,14.0
"2011","Stockton-on-Tees 015","E02002549","Total",7844,3712,4132,7762,82,78,365.76,21.4
"2011","Stockton-on-Tees 016","E02002550","Total",6398,3126,3272,6296,102,90,268.06,23.9
"2011","Stockton-on-Tees 017","E02002551","Total",6531,3215,3316,5895,636,74,341.58,19.1
"2011","Stockton-on-Tees 018","E02002552","Total",6814,3332,3482,6814,0,43,167.12,40.8
"2011","Stockton-on-Tees 019","E02002553","Total",5891,2871,3020,5847,44,41,150.62,39.1
"2011","Stockton-on-Tees 020","E02002554","Total",5505,2592,2913,5426,79,23,314.31,17.5
"2011","Stockton-on-Tees 021","E02002555","Total",9928,4813,5115,9827,101,173,696.94,14.2
"2011","Stockton-on-Tees 022","E02002556","Total",7160,3603,3557,7160,0,135,1339.05,5.3
"2011","Stockton-on-Tees 023","E02002557","Total",13885,6858,7027,13835,50,180,430.75,32.2
"2011","Stockton-on-Tees 024","E02002558","Total",9745,4934,4811,9417,328,180,1807.92,5.4
"2011","Gateshead 001","E02001682","Total",7853,3800,4053,7819,34,78,801.97,9.8
"2011","Gateshead 002","E02001683","Total",9134,4392,4742,9034,100,82,1300.57,7.0
"2011","Gateshead 003","E02001684","Total",6867,3336,3531,6813,54,34,371.89,18.5
"2011","Gateshead 004","E02001685","Total",8256,3963,4293,8247,9,33,183.07,45.1
"2011","Gateshead 005","E02001686","Total",7099,3371,3728,6949,150,52,563.09,12.6
"2011","Gateshead 007","E02001688","Total",7726,3931,3795,7672,54,23,493.64,15.7
"2011","Gateshead 008","E02001689","Total",8243,4359,3884,7718,525,82,113.44,72.7
"2011","Gateshead 009","E02001690","Total",7579,3735,3844,7511,68,55,364.41,20.8
"2011","Gateshead 010","E02001691","Total",8327,4202,4125,8268,59,42,144.96,57.4
"2011","Gateshead 011","E02001692","Total",6414,3085,3329,6414,0,23,119.41,53.7
"2011","Gateshead 012","E02001693","Total",5613,2727,2886,5570,43,20,108.71,51.6
"2011","Gateshead 013","E02001694","Total",6565,3196,3369,6562,3,41,238.49,27.5
"2011","Gateshead 014","E02001695","Total",6345,3128,3217,6345,0,40,384.47,16.5
"2011","Gateshead 015","E02001696","Total",9399,4453,4946,9399,0,31,227.86,41.2
"2011","Gateshead 016","E02001697","Total",7823,3780,4043,7709,114,73,143.36,54.6
"2011","Gateshead 017","E02001698","Total",7272,3559,3713,7203,69,80,197.35,36.8
"2011","Gateshead 018","E02001699","Total",6980,3394,3586,6942,38,33,211.02,33.1
"2011","Gateshead 019","E02001700","Total",10606,5090,5516,10579,27,87,1654.29,6.4
"2011","Gateshead 020","E02001701","Total",6320,3070,3250,6152,168,62,155.13,40.7
"2011","Gateshead 021","E02001702","Total",8055,3899,4156,7997,58,37,192.70,41.8
"2011","Gateshead 022","E02001703","Total",5702,2742,2960,5699,3,74,1008.07,5.7
"2011","Gateshead 023","E02001704","Total",7156,3454,3702,7150,6,24,153.12,46.7
"2011","Gateshead 024","E02001705","Total",7045,3419,3626,6979,66,64,1915.43,3.7
"2011","Gateshead 025","E02001706","Total",6653,3183,3470,6597,56,42,2462.24,2.7
"2011","Gateshead 026","E02001707","Total",8367,4045,4322,8248,119,47,381.22,21.9
"2011","Gateshead 027","E02006841","Total",7487,3971,3516,7086,401,29,277.19,27.0
"2011","Gateshead 028","E02006842","Total",5328,2690,2638,5064,264,44,67.64,78.8
"2011","Newcastle upon Tyne 001","E02001708","Total",9735,4729,5006,9684,51,91,2178.27,4.5
"2011","Newcastle upon Tyne 002","E02001709","Total",10237,4982,5255,10207,30,194,806.40,12.7
"2011","Newcastle upon Tyne 003","E02001710","Total",9826,4781,5045,9726,100,31,198.82,49.4
"2011","Newcastle upon Tyne 004","E02001711","Total",9703,4654,5049,9559,144,61,1787.53,5.4
"2011","Newcastle upon Tyne 005","E02001712","Total",9924,4938,4986,9588,336,171,205.22,48.4
"2011","Newcastle upon Tyne 006","E02001713","Total",10492,5137,5355,10266,226,256,238.27,44.0
"2011","Newcastle upon Tyne 007","E02001714","Total",9817,4833,4984,9526,291,163,300.64,32.7
"2011","Newcastle upon Tyne 008","E02001715","Total",11323,5577,5746,11271,52,100,347.15,32.6
"2011","Newcastle upon Tyne 011","E02001718","Total",5655,2737,2918,5638,17,12,131.47,43.0
"2011","Newcastle upon Tyne 012","E02001719","Total",9339,4621,4718,8921,418,97,199.48,46.8
"2011","Newcastle upon Tyne 013","E02001720","Total",9726,5132,4594,9669,57,167,132.39,73.5
"2011","Newcastle upon Tyne 014","E02001721","Total",10261,4964,5297,10171,90,48,959.49,10.7
"2011","Newcastle upon Tyne 015","E02001722","Total",9667,4582,5085,9595,72,51,212.98,45.4
"2011","Newcastle upon Tyne 016","E02001723","Total",6368,2981,3387,6304,64,56,133.11,47.8
"2011","Newcastle upon Tyne 017","E02001724","Total",9211,4831,4380,8935,276,106,122.26,75.3
"2011","Newcastle upon Tyne 018","E02001725","Total",10336,5491,4845,10141,195,58,107.70,96.0
"2011","Newcastle upon Tyne 019","E02001726","Total",11839,5703,6136,11494,345,90,242.58,48.8
"2011","Newcastle upon Tyne 020","E02001727","Total",8530,4210,4320,8520,10,49,211.97,40.2
"2011","Newcastle upon Tyne 021","E02001728","Total",9734,4695,5039,9669,65,37,386.69,25.2
"2011","Newcastle upon Tyne 022","E02001729","Total",12296,6834,5462,10974,1322,163,165.07,74.5
"2011","Newcastle upon Tyne 023","E02001730","Total",12926,6833,6093,10461,2465,149,187.15,69.1
"2011","Newcastle upon Tyne 024","E02001731","Total",12281,6665,5616,10850,1431,124,502.43,24.4
"2011","Newcastle upon Tyne 025","E02001732","Total",5031,2449,2582,5000,31,15,206.42,24.4
"2011","Newcastle upon Tyne 026","E02001733","Total",11885,5929,5956,11685,200,38,326.51,36.4
"2011","Newcastle upon Tyne 027","E02001734","Total",7663,3706,3957,7576,87,40,203.11,37.7
"2011","Newcastle upon Tyne 028","E02001735","Total",6614,3063,3551,6568,46,14,107.59,61.5
"2011","Newcastle upon Tyne 029","E02001736","Total",12990,6923,6067,12628,362,102,270.58,48.0
"2011","Newcastle upon Tyne 030","E02001737","Total",6054,3095,2959,5931,123,29,183.21,33.0
"2011","Newcastle upon Tyne 031","E02006893","Total",10714,5151,5563,10655,59,74,289.37,37.0
"2011","North Tyneside 001","E02001738","Total",5625,2746,2879,5622,3,94,601.67,9.3
"2011","North Tyneside 002","E02001739","Total",7508,3669,3839,7454,54,33,487.38,15.4
"2011","North Tyneside 003","E02001740","Total",5789,2838,2951,5779,10,133,118.46,48.9
"2011","North Tyneside 004","E02001741","Total",6967,3289,3678,6922,45,68,724.56,9.6
"2011","North Tyneside 005","E02001742","Total",6037,2824,3213,5997,40,88,114.94,52.5
"2011","North Tyneside 006","E02001743","Total",7569,3774,3795,7281,288,87,129.68,58.4
"2011","North Tyneside 007","E02001744","Total",6531,3113,3418,6442,89,39,757.45,8.6
"2011","North Tyneside 008","E02001745","Total",6357,3037,3320,6352,5,31,237.14,26.8
"2011","North Tyneside 009","E02001746","Total",8334,3993,4341,8260,74,88,357.76,23.3
"2011","North Tyneside 010","E02001747","Total",6180,2993,3187,6166,14,69,124.60,49.6
"2011","North Tyneside 011","E02001748","Total",7532,3608,3924,7525,7,45,266.83,28.2
"2011","North Tyneside 012","E02001749","Total",6161,3007,3154,6115,46,44,248.26,24.8
"2011","North Tyneside 013","E02001750","Total",6636,3158,3478,6576,60,79,197.03,33.7
"2011","North Tyneside 014","E02001751","Total",6039,2873,3166,5971,68,31,158.32,38.1
"2011","North Tyneside 015","E02001752","Total",6281,2964,3317,6281,0,35,315.88,19.9
"2011","North Tyneside 016","E02001753","Total",6304,3029,3275,6250,54,60,186.90,33.7
"2011","North Tyneside 017","E02001754","Total",6025,2900,3125,5914,111,80,159.35,37.8
"2011","North Tyneside 018","E02001755","Total",7985,3878,4107,7865,120,69,558.06,14.3
"2011","North Tyneside 019","E02001756","Total",9258,4419,4839,9258,0,54,311.63,29.7
"2011","North Tyneside 020","E02001757","Total",5918,2800,3118,5883,35,43,155.83,38.0
"2011","North Tyneside 021","E02001758","Total",5599,2622,2977,5599,0,40,164.25,34.1
"2011","North Tyneside 022","E02001759","Total",6294,3125,3169,6182,112,32,95.17,66.1
"2011","North Tyneside 023","E02001760","Total",7775,3662,4113,7706,69,26,233.69,33.3
"2011","North Tyneside 024","E02001761","Total",5397,2579,2818,5342,55,20,113.30,47.6
"2011","North Tyneside 025","E02001762","Total",5588,2764,2824,5588,0,28,236.58,23.6
"2011","North Tyneside 026","E02001763","Total",6307,3052,3255,6262,45,29,121.00,52.1
"2011","North Tyneside 027","E02001764","Total",7559,3855,3704,7488,71,24,379.63,19.9
"2011","North Tyneside 028","E02001765","Total",7281,3481,3800,7137,144,18,251.35,29.0
"2011","North Tyneside 029","E02001766","Total",6927,3467,3460,6927,0,32,213.39,32.5
"2011","North Tyneside 030","E02001767","Total",7038,3364,3674,6998,40,31,219.01,32.1
"2011","South Tyneside 001","E02001768","Total",8446,4183,4263,8251,195,56,197.80,42.7
"2011","South Tyneside 002","E02001769","Total",7396,3828,3568,7342,54,33,203.19,36.4
"2011","South Tyneside 003","E02001770","Total",6552,3306,3246,6272,280,63,83.64,78.3
"2011","South Tyneside 004","E02001771","Total",6405,2996,3409,6305,100,33,227.44,28.2
"2011","South Tyneside 005","E02001772","Total",5412,2616,2796,5375,37,28,122.56,44.2
"2011","South Tyneside 006","E02001773","Total",5457,2588,2869,5457,0,49,126.33,43.2
"2011","South Tyneside 007","E02001774","Total",5495,2724,2771,5368,127,35,326.60,16.8
"2011","South Tyneside 008","E02001775","Total",5637,2703,2934,5621,16,16,86.74,65.0
"2011","South Tyneside 009","E02001776","Total",8387,4082,4305,8289,98,38,195.68,42.9
"2011","South Tyneside 010","E02001777","Total",6330,3095,3235,6244,86,34,204.48,31.0
"2011","South Tyneside 011","E02001778","Total",6152,3007,3145,6013,139,15,105.86,58.1
"2011","South Tyneside 012","E02001779","Total",5449,2663,2786,5369,80,17,268.40,20.3
"2011","South Tyneside 013","E02001780","Total",5194,2430,2764,5190,4,30,120.06,43.3
"2011","South Tyneside 014","E02001781","Total",5419,2577,2842,5404,15,18,115.63,46.9
"2011","South Tyneside 015","E02001782","Total",8656,4106,4550,8569,87,37,325.67,26.6
"2011","South Tyneside 016","E02001783","Total",6679,3098,3581,6679,0,27,147.97,45.1
"2011","South Tyneside 017","E02001784","Total",6837,3249,3588,6810,27,33,232.58,29.4
"2011","South Tyneside 018","E02001785","Total",7902,3753,4149,7891,11,51,657.29,12.0
"2011","South Tyneside 019","E02001786","Total",7015,3385,3630,6973,42,36,196.18,35.8
"2011","South Tyneside 020","E02001787","Total",5623,2686,2937,5623,0,22,804.01,7.0
"2011","South Tyneside 021","E02001788","Total",5899,2901,2998,5899,0,37,207.44,28.4
"2011","South Tyneside 022","E02001789","Total",5829,2767,3062,5829,0,109,635.89,9.2
"2011","South Tyneside 023","E02001790","Total",5956,2817,3139,5956,0,50,849.87,7.0
"2011","Sunderland 001","E02001791","Total",5788,2789,2999,5783,5,37,191.72,30.2
"2011","Sunderland 002","E02001792","Total",7133,3403,3730,6951,182,55,163.89,43.5
"2011","Sunderland 003","E02001793","Total",8383,3934,4449,8357,26,27,191.39,43.8
"2011","Sunderland 004","E02001794","Total",8674,4073,4601,8502,172,24,258.00,33.6
"2011","Sunderland 005","E02001795","Total",7585,3672,3913,7521,64,26,242.53,31.3
"2011","Sunderland 006","E02001796","Total",9277,4680,4597,9144,133,41,180.51,51.4
"2011","Sunderland 007","E02001797","Total",5851,2908,2943,5766,85,39,1260.14,4.6
"2011","Sunderland 008","E02001798","Total",8260,3971,4289,8156,104,35,299.81,27.6
"2011","Sunderland 009","E02001799","Total",10004,4737,5267,9948,56,45,257.35,38.9
"2011","Sunderland 010","E02001800","Total",7275,3534,3741,7267,8,27,339.01,21.5
"2011","Sunderland 011","E02001801","Total",6623,3281,3342,5890,733,63,87.32,75.8
"2011","Sunderland 012","E02001802","Total",6302,2916,3386,6302,0,24,169.08,37.3
"2011","Sunderland 013","E02001803","Total",8644,4735,3909,7897,747,100,252.41,34.2
"2011","Sunderland 014","E02001804","Total",6457,3154,3303,6317,140,18,225.94,28.6
"2011","Sunderland 015","E02001805","Total",5858,2826,3032,5711,147,39,127.13,46.1
"2011","Sunderland 016","E02001806","Total",8565,4401,4164,8335,230,32,297.12,28.8
"2011","Sunderland 017","E02001807","Total",7297,3526,3771,7260,37,49,524.45,13.9
"2011","Sunderland 018","E02001808","Total",6058,2996,3062,6055,3,34,91.00,66.6
"2011","Sunderland 019","E02001809","Total",6559,3190,3369,6547,12,30,219.05,29.9
"2011","Sunderland 020","E02001810","Total",8582,4264,4318,8577,5,50,228.53,37.6
"2011","Sunderland 021","E02001811","Total",9184,4352,4832,9174,10,32,234.56,39.2
"2011","Sunderland 022","E02001812","Total",10468,5163,5305,10316,152,114,271.10,38.6
"2011","Sunderland 023","E02001813","Total",10093,4813,5280,10054,39,30,223.63,45.1
"2011","Sunderland 024","E02001814","Total",6407,3110,3297,6366,41,31,225.83,28.4
"2011","Sunderland 025","E02001815","Total",10328,5053,5275,10326,2,120,495.49,20.8
"2011","Sunderland 026","E02001816","Total",6913,3176,3737,6839,74,31,253.36,27.3
"2011","Sunderland 027","E02001817","Total",6290,3014,3276,6235,55,23,150.56,41.8
"2011","Sunderland 028","E02001818","Total",8435,4035,4400,8335,100,30,425.04,19.8
"2011","Sunderland 029","E02001819","Total",6941,3379,3562,6941,0,55,372.48,18.6
"2011","Sunderland 030","E02001820","Total",8528,4172,4356,8521,7,48,385.65,22.1
"2011","Sunderland 031","E02001821","Total",5948,2869,3079,5942,6,31,779.91,7.6
"2011","Sunderland 032","E02001822","Total",7597,3729,3868,7497,100,47,1671.14,4.5
"2011","Sunderland 033","E02001823","Total",7129,3455,3674,7090,39,29,271.55,26.3
"2011","Sunderland 034","E02001824","Total",8406,4036,4370,8367,39,48,318.91,26.4
"2011","Sunderland 035","E02001825","Total",7065,3416,3649,7003,62,42,1052.70,6.7
"2011","Sunderland 036","E02001826","Total",6599,3191,3408,6592,7,25,1007.88,6.5
"2011","Blackburn with Darwen 001","E02002615","Total",9298,4559,4739,9266,32,85,475.84,19.5
"2011","Blackburn with Darwen 002","E02002616","Total",8617,4262,4355,8527,90,168,252.25,34.2
"2011","Blackburn with Darwen 003","E02002617","Total",8913,4459,4454,8893,20,66,145.03,61.5
"2011","Blackburn with Darwen 004","E02002618","Total",7543,3761,3782,7400,143,84,77.38,97.5
"2011","Blackburn with Darwen 005","E02002619","Total",8784,4516,4268,8582,202,89,109.77,80.0
"2011","Blackburn with Darwen 006","E02002620","Total",8465,4451,4014,8163,302,55,245.24,34.5
"2011","Blackburn with Darwen 007","E02002621","Total",8381,4262,4119,8381,0,93,119.39,70.2
"2011","Blackburn with Darwen 008","E02002622","Total",10137,5101,5036,9866,271,68,257.16,39.4
"2011","Blackburn with Darwen 009","E02002623","Total",10066,5023,5043,10006,60,56,205.26,49.0
"2011","Blackburn with Darwen 010","E02002624","Total",8121,4006,4115,8056,65,159,1422.54,5.7
"2011","Blackburn with Darwen 011","E02002625","Total",9930,4839,5091,9783,147,70,498.38,19.9
"2011","Blackburn with Darwen 012","E02002626","Total",7216,3489,3727,7167,49,67,188.35,38.3
"2011","Blackburn with Darwen 013","E02002627","Total",7703,3900,3803,7672,31,56,292.67,26.3
"2011","Blackburn with Darwen 014","E02002628","Total",7056,3407,3649,6911,145,52,382.77,18.4
"2011","Blackburn with Darwen 015","E02002629","Total",5783,2828,2955,5767,16,26,128.03,45.2
"2011","Blackburn with Darwen 016","E02002630","Total",6106,3040,3066,6042,64,49,361.16,16.9
"2011","Blackburn with Darwen 017","E02002631","Total",9101,4554,4547,9076,25,88,1109.46,8.2
"2011","Blackburn with Darwen 018","E02002632","Total",6269,3090,3179,6269,0,136,7430.50,0.8
"2011","Blackpool 001","E02002633","Total",7808,3660,4148,7683,125,71,175.07,44.6
"2011","Blackpool 002","E02002634","Total",8256,3955,4301,8251,5,85,257.76,32.0
"2011","Blackpool 003","E02002635","Total",7996,3881,4115,7784,212,78,191.79,41.7
"2011","Blackpool 004","E02002636","Total",8374,3979,4395,8363,11,77,262.94,31.8
"2011","Blackpool 005","E02002637","Total",6189,3018,3171,6143,46,55,120.96,51.2
"2011","Blackpool 006","E02002638","Total",6406,3578,2828,5670,736,27,118.24,54.2
"2011","Blackpool 007","E02002639","Total",5770,2803,2967,5746,24,36,113.17,51.0
"2011","Blackpool 008","E02002640","Total",7317,3712,3605,7259,58,16,87.11,84.0
"2011","Blackpool 009","E02002641","Total",8268,3903,4365,8106,162,83,208.13,39.7
"2011","Blackpool 010","E02002642","Total",7081,3836,3245,6224,857,33,123.08,57.5
"2011","Blackpool 011","E02002643","Total",7502,3720,3782,7422,80,50,80.10,93.7
"2011","Blackpool 012","E02002644","Total",8035,3886,4149,7962,73,86,310.27,25.9
"2011","Blackpool 013","E02002645","Total",5777,3147,2630,4811,966,23,117.17,49.3
"2011","Blackpool 014","E02002646","Total",7102,3398,3704,7069,33,42,360.74,19.7
"2011","Blackpool 015","E02002647","Total",8203,3994,4209,8157,46,49,117.42,69.9
"2011","Blackpool 016","E02002648","Total",7329,3525,3804,7322,7,59,119.86,61.1
"2011","Blackpool 017","E02002649","Total",8587,4204,4383,8123,464,68,167.11,51.4
"2011","Blackpool 018","E02002650","Total",7983,3744,4239,7960,23,64,425.81,18.7
"2011","Blackpool 019","E02002651","Total",8082,3832,4250,7905,177,71,131.37,61.5
"2011","Cheshire East 022","E02003811","Total",5893,2941,2952,5880,13,149,7282.33,0.8
"2011","Cheshire East 023","E02003812","Total",5605,2699,2906,5576,29,145,515.32,10.9
"2011","Cheshire East 024","E02003813","Total",6248,3086,3162,6144,104,75,221.94,28.2
"2011","Cheshire East 025","E02003814","Total",7347,3628,3719,7346,1,71,577.90,12.7
"2011","Cheshire East 026","E02003815","Total",6818,3391,3427,6747,71,69,566.52,12.0
"2011","Cheshire East 027","E02003816","Total",6823,3371,3452,6703,120,68,264.48,25.8
"2011","Cheshire East 028","E02003817","Total",7029,3426,3603,6951,78,105,316.45,22.2
"2011","Cheshire East 029","E02003818","Total",5812,2854,2958,5745,67,98,1107.92,5.2
"2011","Cheshire East 030","E02003819","Total",5748,2753,2995,5681,67,107,463.89,12.4
"2011","Cheshire East 031","E02003820","Total",6792,3379,3413,6745,47,121,684.06,9.9
"2011","Cheshire East 032","E02003821","Total",5436,2649,2787,5408,28,87,355.02,15.3
"2011","Cheshire East 033","E02003822","Total",10634,5286,5348,10551,83,151,7836.41,1.4
"2011","Cheshire East 040","E02003823","Total",6525,3136,3389,6504,21,116,527.16,12.4
"2011","Cheshire East 042","E02003824","Total",5250,2582,2668,5163,87,99,379.88,13.8
"2011","Cheshire East 034","E02003825","Total",6800,3479,3321,6768,32,73,127.67,53.3
"2011","Cheshire East 035","E02003826","Total",7513,3627,3886,7402,111,32,414.85,18.1
"2011","Cheshire East 036","E02003827","Total",8707,4307,4400,8707,0,51,172.17,50.6
"2011","Cheshire East 037","E02003828","Total",6713,3259,3454,6664,49,32,398.91,16.8
"2011","Cheshire East 038","E02003829","Total",6436,3156,3280,5546,890,82,390.12,16.5
"2011","Cheshire East 039","E02003830","Total",7294,3606,3688,7163,131,42,221.57,32.9
"2011","Cheshire East 041","E02003831","Total",9062,4419,4643,8968,94,173,4036.90,2.2
"2011","Cheshire East 043","E02003832","Total",6008,3121,2887,6008,0,48,102.91,58.4
"2011","Cheshire East 044","E02003833","Total",6374,3107,3267,6361,13,53,452.93,14.1
"2011","Cheshire East 045","E02003834","Total",6737,3399,3338,6671,66,59,166.67,40.4
"2011","Cheshire East 046","E02003835","Total",7853,3893,3960,7846,7,130,546.55,14.4
"2011","Cheshire East 047","E02003836","Total",6898,3298,3600,6787,111,61,282.39,24.4
"2011","Cheshire East 049","E02003837","Total",12035,6018,6017,11739,296,227,16039.35,0.8
"2011","Cheshire East 048","E02003838","Total",6104,2962,3142,6104,0,67,617.03,9.9
"2011","Cheshire East 050","E02003839","Total",7066,3395,3671,6964,102,85,226.21,31.2
"2011","Cheshire East 051","E02003840","Total",10043,4965,5078,9941,102,239,18844.98,0.5
"2011","Cheshire East 001","E02003853","Total",5688,2805,2883,5638,50,103,2795.18,2.0
"2011","Cheshire East 002","E02003854","Total",6402,3082,3320,6402,0,133,432.10,14.8
"2011","Cheshire East 003","E02003855","Total",6614,3215,3399,6479,135,146,379.44,17.4
"2011","Cheshire East 004","E02003856","Total",10241,5039,5202,10165,76,162,740.71,13.8
"2011","Cheshire East 005","E02003857","Total",6396,3181,3215,6396,0,128,226.42,28.2
"2011","Cheshire East 006","E02003858","Total",6605,3204,3401,6568,37,218,696.03,9.5
"2011","Cheshire East 007","E02003859","Total",11807,5640,6167,10978,829,258,16292.49,0.7
"2011","Cheshire East 008","E02003860","Total",6990,3413,3577,6988,2,167,342.37,20.4
"2011","Cheshire East 009","E02003861","Total",6418,3088,3330,6374,44,81,432.76,14.8
"2011","Cheshire East 011","E02003862","Total",5128,2420,2708,4970,158,190,3566.44,1.4
"2011","Cheshire East 010","E02003863","Total",6773,3269,3504,6762,11,181,572.47,11.8
"2011","Cheshire East 012","E02003864","Total",8026,3853,4173,7812,214,214,3019.13,2.7
"2011","Cheshire East 013","E02003865","Total",7593,3741,3852,7522,71,104,582.38,13.0
"2011","Cheshire East 014","E02003866","Total",5961,2961,3000,5959,2,183,258.51,23.1
"2011","Cheshire East 015","E02003867","Total",7544,3649,3895,7450,94,168,365.33,20.6
"2011","Cheshire East 016","E02003868","Total",8257,4049,4208,8244,13,95,456.56,18.1
"2011","Cheshire East 017","E02003869","Total",7020,3458,3562,6819,201,131,238.31,29.5
"2011","Cheshire East 018","E02003870","Total",10288,5098,5190,10201,87,118,224.71,45.8
"2011","Cheshire East 019","E02003871","Total",6996,3381,3615,6996,0,92,150.82,46.4
"2011","Cheshire East 020","E02003872","Total",9657,4738,4919,9588,69,222,20375.08,0.5
"2011","Cheshire East 021","E02003873","Total",6120,2933,3187,5971,149,47,349.90,17.5
"2011","Cheshire West and Chester 022","E02003794","Total",8609,4271,4338,8426,183,151,5659.36,1.5
"2011","Cheshire West and Chester 025","E02003795","Total",5595,2730,2865,5454,141,96,4398.01,1.3
"2011","Cheshire West and Chester 027","E02003796","Total",7178,3402,3776,7169,9,97,258.87,27.7
"2011","Cheshire West and Chester 028","E02003797","Total",9547,4607,4940,9252,295,170,419.88,22.7
"2011","Cheshire West and Chester 029","E02003798","Total",6060,2877,3183,6009,51,48,148.36,40.8
"2011","Cheshire West and Chester 031","E02003799","Total",7039,3421,3618,6994,45,45,154.61,45.5
"2011","Cheshire West and Chester 030","E02003800","Total",6273,3025,3248,6243,30,123,1891.31,3.3
"2011","Cheshire West and Chester 032","E02003801","Total",7019,3426,3593,6977,42,112,154.59,45.4
"2011","Cheshire West and Chester 033","E02003802","Total",8051,4179,3872,7831,220,78,136.91,58.8
"2011","Cheshire West and Chester 034","E02003803","Total",8909,4138,4771,8405,504,118,437.79,20.3
"2011","Cheshire West and Chester 036","E02003804","Total",6773,3312,3461,6764,9,86,154.30,43.9
"2011","Cheshire West and Chester 039","E02003805","Total",6195,2978,3217,6113,82,151,1951.80,3.2
"2011","Cheshire West and Chester 041","E02003806","Total",5942,2884,3058,5942,0,127,735.24,8.1
"2011","Cheshire West and Chester 043","E02003807","Total",8181,3912,4269,8129,52,167,523.03,15.6
"2011","Cheshire West and Chester 044","E02003808","Total",6419,3157,3262,6419,0,57,131.02,49.0
"2011","Cheshire West and Chester 046","E02003809","Total",7496,3652,3844,7406,90,170,14439.87,0.5
"2011","Cheshire West and Chester 047","E02003810","Total",7973,3871,4102,7915,58,170,13209.21,0.6
"2011","Cheshire West and Chester 001","E02003841","Total",7636,3641,3995,7573,63,107,1296.07,5.9
"2011","Cheshire West and Chester 004","E02003842","Total",5332,2592,2740,5280,52,145,3000.73,1.8
"2011","Cheshire West and Chester 005","E02003843","Total",5852,2852,3000,5824,28,47,247.48,23.6
"2011","Cheshire West and Chester 006","E02003844","Total",6772,3269,3503,6761,11,112,392.63,17.2
"2011","Cheshire West and Chester 007","E02003845","Total",8128,3929,4199,8000,128,44,706.26,11.5
"2011","Cheshire West and Chester 008","E02003846","Total",6781,3192,3589,6736,45,30,144.26,47.0
"2011","Cheshire West and Chester 009","E02003847","Total",9625,4782,4843,9625,0,149,396.74,24.3
"2011","Cheshire West and Chester 010","E02003848","Total",5113,2465,2648,5048,65,35,118.49,43.2
"2011","Cheshire West and Chester 011","E02003849","Total",6855,3371,3484,6820,35,25,2070.58,3.3
"2011","Cheshire West and Chester 013","E02003850","Total",5351,2593,2758,5351,0,46,111.94,47.8
"2011","Cheshire West and Chester 014","E02003851","Total",5891,2886,3005,5826,65,62,221.07,26.6
"2011","Cheshire West and Chester 016","E02003852","Total",6870,3420,3450,6829,41,77,136.44,50.4
"2011","Cheshire West and Chester 002","E02003874","Total",9077,4335,4742,8985,92,161,2087.23,4.3
"2011","Cheshire West and Chester 003","E02003875","Total",6414,3264,3150,6410,4,163,7553.11,0.8
"2011","Cheshire West and Chester 012","E02003876","Total",5614,2702,2912,5601,13,51,305.36,18.4
"2011","Cheshire West and Chester 015","E02003877","Total",9214,4492,4722,9098,116,217,4301.76,2.1
"2011","Cheshire West and Chester 017","E02003878","Total",8009,4003,4006,7842,167,104,5985.42,1.3
"2011","Cheshire West and Chester 018","E02003879","Total",6270,3089,3181,6145,125,40,585.50,10.7
"2011","Cheshire West and Chester 019","E02003880","Total",6391,3101,3290,6361,30,74,801.60,8.0
"2011","Cheshire West and Chester 020","E02003881","Total",6069,3022,3047,6036,33,68,172.57,35.2
"2011","Cheshire West and Chester 021","E02003882","Total",9513,4711,4802,9512,1,61,263.67,36.1
"2011","Cheshire West and Chester 023","E02003883","Total",9893,4824,5069,9891,2,243,679.94,14.5
"2011","Cheshire West and Chester 024","E02003884","Total",7897,3878,4019,7784,113,174,3796.67,2.1
"2011","Cheshire West and Chester 026","E02003885","Total",5646,2801,2845,5582,64,115,2507.02,2.3
"2011","Cheshire West and Chester 035","E02003886","Total",6647,3211,3436,6532,115,38,680.61,9.8
"2011","Cheshire West and Chester 037","E02003887","Total",6137,3009,3128,6137,0,81,648.84,9.5
"2011","Cheshire West and Chester 038","E02003888","Total",6124,2987,3137,5989,135,65,226.90,27.0
"2011","Cheshire West and Chester 040","E02003889","Total",5643,2669,2974,5643,0,38,271.23,20.8
"2011","Cheshire West and Chester 042","E02003890","Total",5930,2874,3056,5923,7,72,373.81,15.9
"2011","Cheshire West and Chester 045","E02003891","Total",5655,2780,2875,5644,11,143,6777.51,0.8
"2011","Halton 001","E02002574","Total",7137,3520,3617,7094,43,80,491.31,14.5
"2011","Halton 002","E02002575","Total",9666,4875,4791,9642,24,138,241.10,40.1
"2011","Halton 003","E02002576","Total",7369,3621,3748,7256,113,52,331.44,22.2
"2011","Halton 004","E02002577","Total",7495,3579,3916,7415,80,43,140.36,53.4
"2011","Halton 005","E02002578","Total",7725,3695,4030,7702,23,68,235.29,32.8
"2011","Halton 006","E02002579","Total",7805,3672,4133,7711,94,42,146.80,53.2
"2011","Halton 007","E02002580","Total",7512,3689,3823,7452,60,32,386.96,19.4
"2011","Halton 008","E02002581","Total",7353,3577,3776,7287,66,60,1390.45,5.3
"2011","Halton 009","E02002582","Total",8192,4089,4103,8148,44,120,2104.90,3.9
"2011","Halton 010","E02002583","Total",6851,3418,3433,6851,0,43,528.87,13.0
"2011","Halton 011","E02002584","Total",7460,3584,3876,7392,68,46,156.35,47.7
"2011","Halton 012","E02002585","Total",10492,5247,5245,10428,64,69,720.56,14.6
"2011","Halton 013","E02002586","Total",9816,4747,5069,9699,117,53,245.20,40.0
"2011","Halton 014","E02002587","Total",6925,3327,3598,6914,11,34,202.45,34.2
"2011","Halton 015","E02002588","Total",7500,3568,3932,7439,61,51,194.37,38.6
"2011","Halton 016","E02002589","Total",6448,3160,3288,6444,4,70,393.11,16.4
"2011","Warrington 001","E02002590","Total",7215,4042,3173,6100,1115,147,2181.07,3.3
"2011","Warrington 002","E02002591","Total",6435,3080,3355,6395,40,94,1603.66,4.0
"2011","Warrington 003","E02002592","Total",6348,3095,3253,6100,248,56,1838.31,3.5
"2011","Warrington 004","E02002593","Total",5236,2617,2619,5226,10,67,444.81,11.8
"2011","Warrington 005","E02002594","Total",5465,2727,2738,5452,13,49,366.22,14.9
"2011","Warrington 006","E02002595","Total",7920,3804,4116,7918,2,45,281.78,28.1
"2011","Warrington 007","E02002596","Total",8503,4140,4363,8189,314,92,273.46,31.1
"2011","Warrington 008","E02002597","Total",9001,4389,4612,8994,7,44,162.56,55.4
"2011","Warrington 009","E02002598","Total",7690,3853,3837,7660,30,141,575.40,13.4
"2011","Warrington 010","E02002599","Total",10910,5408,5502,10774,136,182,339.84,32.1
"2011","Warrington 011","E02002600","Total",9183,4536,4647,9142,41,49,184.26,49.8
"2011","Warrington 012","E02002601","Total",7931,3880,4051,7928,3,87,287.60,27.6
"2011","Warrington 013","E02002602","Total",7345,3671,3674,7268,77,24,261.19,28.1
"2011","Warrington 014","E02002603","Total",7156,3553,3603,7065,91,89,908.83,7.9
"2011","Warrington 015","E02002604","Total",7693,3784,3909,7590,103,104,168.05,45.8
"2011","Warrington 016","E02002605","Total",9234,4532,4702,9234,0,93,236.80,39.0
"2011","Warrington 017","E02002606","Total",10174,5218,4956,9954,220,56,273.12,37.3
"2011","Warrington 018","E02002607","Total",9964,5100,4864,9914,50,61,638.34,15.6
"2011","Warrington 019","E02002608","Total",8543,4058,4485,8382,161,101,1349.81,6.3
"2011","Warrington 020","E02002609","Total",8134,4089,4045,8038,96,45,246.90,32.9
"2011","Warrington 021","E02002610","Total",12350,6031,6319,12261,89,281,1685.61,7.3
"2011","Warrington 022","E02002611","Total",7952,3844,4108,7862,90,175,285.37,27.9
"2011","Warrington 023","E02002612","Total",9352,4568,4784,9232,120,136,237.56,39.4
"2011","Warrington 024","E02002613","Total",6398,3293,3105,6054,344,170,2599.41,2.5
"2011","Warrington 025","E02002614","Total",6096,2988,3108,6096,0,201,635.43,9.6
"2011","Allerdale 001","E02003965","Total",10902,5232,5670,10690,212,129,12457.46,0.9
"2011","Allerdale 002","E02003966","Total",7063,3557,3506,6928,135,99,37628.76,0.2
"2011","Allerdale 003","E02003967","Total",8285,4128,4157,8260,25,85,17069.98,0.5
"2011","Allerdale 004","E02003968","Total",8619,4278,4341,8520,99,102,2166.26,4.0
"2011","Allerdale 005","E02003969","Total",6690,3253,3437,6637,53,38,1674.41,4.0
"2011","Allerdale 006","E02003970","Total",7750,3804,3946,7669,81,160,7858.53,1.0
"2011","Allerdale 007","E02003971","Total",8021,3945,4076,7945,76,175,19797.34,0.4
"2011","Allerdale 008","E02003972","Total",9232,4623,4609,9200,32,85,1829.11,5.0
"2011","Allerdale 009","E02003973","Total",8751,4327,4424,8717,34,52,395.17,22.1
"2011","Allerdale 010","E02003974","Total",7796,3728,4068,7710,86,57,339.75,22.9
"2011","Allerdale 011","E02003975","Total",6455,3150,3305,6258,197,91,2797.23,2.3
"2011","Allerdale 012","E02003976","Total",6858,3346,3512,6436,422,109,20144.29,0.3
"2011","Barrow-in-Furness 001","E02003977","Total",6407,3185,3222,6375,32,81,2686.87,2.4
"2011","Barrow-in-Furness 002","E02003978","Total",5935,2927,3008,5890,45,69,591.50,10.0
"2011","Barrow-in-Furness 003","E02003979","Total",7709,3762,3947,7487,222,139,648.64,11.9
"2011","Barrow-in-Furness 004","E02003980","Total",6705,3382,3323,6705,0,35,575.40,11.7
"2011","Barrow-in-Furness 005","E02003981","Total",6829,3360,3469,6743,86,98,147.56,46.3
"2011","Barrow-in-Furness 006","E02003982","Total",7594,3732,3862,7552,42,111,1300.26,5.8
"2011","Barrow-in-Furness 007","E02003983","Total",7733,3809,3924,7690,43,62,124.89,61.9
"2011","Barrow-in-Furness 008","E02003984","Total",6908,3451,3457,6742,166,44,106.19,65.1
"2011","Barrow-in-Furness 009","E02003985","Total",6679,3256,3423,6626,53,51,615.38,10.9
"2011","Barrow-in-Furness 010","E02003986","Total",6588,3321,3267,6582,6,47,999.36,6.6
"2011","Carlisle 001","E02003987","Total",6056,3061,2995,5983,73,67,37285.48,0.2
"2011","Carlisle 002","E02003988","Total",6629,3239,3390,6537,92,84,25941.06,0.3
"2011","Carlisle 003","E02003989","Total",7609,3692,3917,7609,0,88,395.11,19.3
"2011","Carlisle 004","E02003990","Total",9757,4718,5039,9550,207,164,3560.42,2.7
"2011","Carlisle 005","E02003991","Total",7721,3756,3965,7628,93,100,5793.90,1.3
"2011","Carlisle 006","E02003992","Total",8594,4284,4310,8329,265,120,380.03,22.6
"2011","Carlisle 007","E02003993","Total",8582,4180,4402,8550,32,206,20789.67,0.4
"2011","Carlisle 008","E02003994","Total",7515,3639,3876,7308,207,56,208.72,36.0
"2011","Carlisle 009","E02003995","Total",9494,4591,4903,9445,49,38,222.98,42.6
"2011","Carlisle 010","E02003996","Total",9698,4846,4852,9614,84,64,324.13,29.9
"2011","Carlisle 011","E02003997","Total",9581,4572,5009,9545,36,48,241.33,39.7
"2011","Carlisle 012","E02003998","Total",6908,3315,3593,6841,67,28,157.37,43.9
"2011","Carlisle 013","E02003999","Total",9380,4585,4795,9199,181,119,8629.72,1.1
"2011","Copeland 001","E02004000","Total",5506,2688,2818,5416,90,60,2428.52,2.3
"2011","Copeland 002","E02004001","Total",5612,2899,2713,5520,92,56,219.51,25.6
"2011","Copeland 003","E02004002","Total",10332,5130,5202,10247,85,137,617.34,16.7
"2011","Copeland 004","E02004003","Total",12019,6027,5992,11950,69,115,15738.70,0.8
"2011","Copeland 005","E02004004","Total",9398,4616,4782,9292,106,63,1172.69,8.0
"2011","Copeland 006","E02004005","Total",8194,4067,4127,8156,38,76,1333.00,6.1
"2011","Copeland 007","E02004006","Total",9044,4619,4425,8882,162,178,28659.52,0.3
"2011","Copeland 008","E02004007","Total",10498,5430,5068,9849,649,104,23004.66,0.5
"2011","Eden 001","E02004008","Total",6394,3201,3193,6344,50,147,42269.05,0.2
"2011","Eden 002","E02004009","Total",6078,3060,3018,5854,224,140,22429.24,0.3
"2011","Eden 003","E02004010","Total",7119,3484,3635,6971,148,58,477.69,14.9
"2011","Eden 004","E02004011","Total",9815,4761,5054,9627,188,152,4327.92,2.3
"2011","Eden 005","E02004012","Total",5666,2820,2846,5540,126,104,42091.48,0.1
"2011","Eden 006","E02004013","Total",9903,4942,4961,9754,149,173,46017.76,0.2
"2011","Eden 007","E02004014","Total",7589,3765,3824,7523,66,129,56622.51,0.1
"2011","South Lakeland 001","E02004015","Total",6494,3149,3345,5802,692,115,14978.20,0.4
"2011","South Lakeland 002","E02004016","Total",8401,4138,4263,8092,309,147,8712.25,1.0
"2011","South Lakeland 003","E02004017","Total",8391,4089,4302,8373,18,131,4537.78,1.8
"2011","South Lakeland 004","E02004018","Total",8147,4011,4136,7956,191,114,284.60,28.6
"2011","South Lakeland 005","E02004019","Total",7993,3910,4083,7865,128,133,19405.64,0.4
"2011","South Lakeland 006","E02004020","Total",8283,3990,4293,8188,95,139,379.24,21.8
"2011","South Lakeland 007","E02004021","Total",5276,2644,2632,5120,156,89,23110.03,0.2
"2011","South Lakeland 008","E02004022","Total",5575,2785,2790,5535,40,132,26420.96,0.2
"2011","South Lakeland 009","E02004023","Total",6245,3064,3181,5493,752,146,29022.21,0.2
"2011","South Lakeland 010","E02004024","Total",7185,3485,3700,7125,60,164,12066.70,0.6
"2011","South Lakeland 011","E02004025","Total",8073,3870,4203,7816,257,107,4233.07,1.9
"2011","South Lakeland 012","E02004026","Total",8022,3896,4126,7844,178,97,793.06,10.1
"2011","South Lakeland 013","E02004027","Total",7814,3700,4114,7613,201,123,5274.77,1.5
"2011","South Lakeland 014","E02004028","Total",7759,3791,3968,7692,67,154,4143.49,1.9
"2011","Bolton 001","E02000984","Total",7782,3882,3900,7777,5,139,789.89,9.9
"2011","Bolton 002","E02000985","Total",7569,3674,3895,7566,3,130,369.78,20.5
"2011","Bolton 003","E02000986","Total",8365,4104,4261,8345,20,95,192.30,43.5
"2011","Bolton 004","E02000987","Total",7195,3416,3779,7052,143,71,156.34,46.0
"2011","Bolton 005","E02000988","Total",8407,4136,4271,8371,36,96,195.13,43.1
"2011","Bolton 006","E02000989","Total",8242,3962,4280,8242,0,103,840.00,9.8
"2011","Bolton 007","E02000990","Total",7636,3790,3846,7636,0,86,943.94,8.1
"2011","Bolton 008","E02000991","Total",7682,3780,3902,7662,20,94,695.69,11.0
"2011","Bolton 009","E02000992","Total",5781,2854,2927,5737,44,59,883.04,6.5
"2011","Bolton 010","E02000993","Total",7142,3431,3711,7142,0,53,181.78,39.3
"2011","Bolton 011","E02000994","Total",7914,3942,3972,7914,0,48,114.09,69.4
"2011","Bolton 012","E02000995","Total",8163,3952,4211,8108,55,106,577.54,14.1
"2011","Bolton 013","E02000996","Total",7869,3775,4094,7683,186,41,173.60,45.3
"2011","Bolton 014","E02000997","Total",5676,2791,2885,5586,90,97,1030.25,5.5
"2011","Bolton 015","E02000998","Total",8613,4410,4203,8558,55,59,125.26,68.8
"2011","Bolton 016","E02000999","Total",7435,3903,3532,7091,344,43,322.68,23.0
"2011","Bolton 017","E02001000","Total",9145,4555,4590,8873,272,62,209.83,43.6
"2011","Bolton 018","E02001001","Total",8101,4068,4033,7903,198,131,196.37,41.3
"2011","Bolton 019","E02001002","Total",9445,4558,4887,9445,0,82,383.44,24.6
"2011","Bolton 020","E02001003","Total",7277,3628,3649,7249,28,157,392.87,18.5
"2011","Bolton 021","E02001004","Total",8240,4275,3965,8240,0,63,96.19,85.7
"2011","Bolton 022","E02001005","Total",7937,4056,3881,7860,77,70,251.77,31.5
"2011","Bolton 023","E02001006","Total",7709,3921,3788,7685,24,50,87.81,87.8
"2011","Bolton 024","E02001007","Total",10271,5048,5223,10261,10,70,293.26,35.0
"2011","Bolton 025","E02001008","Total",8140,3979,4161,8067,73,59,127.62,63.8
"2011","Bolton 026","E02001009","Total",6689,3271,3418,6684,5,44,650.75,10.3
"2011","Bolton 027","E02001010","Total",5867,2915,2952,5867,0,25,237.53,24.7
"2011","Bolton 028","E02001011","Total",9855,4925,4930,9853,2,148,498.67,19.8
"2011","Bolton 029","E02001012","Total",7833,3831,4002,7824,9,51,173.05,45.3
"2011","Bolton 030","E02001013","Total",6029,2925,3104,5990,39,72,568.86,10.6
"2011","Bolton 031","E02001014","Total",8168,4009,4159,8168,0,64,719.27,11.4
"2011","Bolton 032","E02001015","Total",7913,3861,4052,7743,170,46,201.92,39.2
"2011","Bolton 033","E02001016","Total",8243,3998,4245,8221,22,41,176.30,46.8
"2011","Bolton 034","E02001017","Total",10849,5295,5554,10849,0,79,658.21,16.5
"2011","Bolton 035","E02001018","Total",7604,3740,3864,7603,1,113,465.31,16.3
"2011","Bury 001","E02001019","Total",8967,4510,4457,8732,235,126,1134.52,7.9
"2011","Bury 002","E02001020","Total",5933,2830,3103,5901,32,127,220.47,26.9
"2011","Bury 003","E02001021","Total",7806,3811,3995,7638,168,200,1214.60,6.4
"2011","Bury 004","E02001022","Total",7860,3822,4038,7693,167,102,506.92,15.5
"2011","Bury 005","E02001023","Total",5833,2819,3014,5825,8,88,231.97,25.1
"2011","Bury 006","E02001024","Total",8083,3984,4099,8032,51,103,238.49,33.9
"2011","Bury 007","E02001025","Total",7608,3735,3873,7495,113,47,430.39,17.7
"2011","Bury 008","E02001026","Total",8964,4536,4428,8839,125,62,234.71,38.2
"2011","Bury 009","E02001027","Total",6787,3330,3457,6552,235,44,185.00,36.7
"2011","Bury 010","E02001028","Total",7430,3602,3828,7388,42,145,290.72,25.6
"2011","Bury 011","E02001029","Total",6974,3492,3482,6898,76,74,208.03,33.5
"2011","Bury 012","E02001030","Total",5817,2835,2982,5758,59,103,662.76,8.8
"2011","Bury 013","E02001031","Total",6464,3160,3304,6463,1,80,532.79,12.1
"2011","Bury 014","E02001032","Total",7552,3683,3869,7445,107,68,314.57,24.0
"2011","Bury 015","E02001033","Total",5613,2741,2872,5603,10,40,268.90,20.9
"2011","Bury 016","E02001034","Total",7766,3828,3938,7736,30,35,174.83,44.4
"2011","Bury 017","E02001035","Total",7200,3541,3659,7190,10,119,547.95,13.1
"2011","Bury 018","E02001036","Total",7253,3548,3705,7252,1,68,481.51,15.1
"2011","Bury 019","E02001037","Total",7118,3425,3693,7032,86,150,550.18,12.9
"2011","Bury 020","E02001038","Total",5568,2620,2948,5567,1,62,197.49,28.2
"2011","Bury 021","E02001039","Total",8174,3880,4294,8174,0,81,165.30,49.4
"2011","Bury 022","E02001040","Total",6020,3006,3014,5887,133,88,406.85,14.8
"2011","Bury 023","E02001041","Total",7616,3686,3930,7613,3,71,121.13,62.9
"2011","Bury 024","E02001042","Total",6193,3135,3058,6167,26,101,145.47,42.6
"2011","Bury 025","E02001043","Total",5468,2561,2907,5249,219,57,354.53,15.4
"2011","Bury 026","E02001044","Total",8993,4468,4525,8896,97,231,128.36,70.1
"2011","Manchester 001","E02001045","Total",7927,3663,4264,7897,30,26,242.00,32.8
"2011","Manchester 002","E02001046","Total",9390,4546,4844,9309,81,38,247.37,38.0
"2011","Manchester 003","E02001047","Total",9870,4831,5039,9856,14,49,234.37,42.1
"2011","Manchester 004","E02001048","Total",8473,4247,4226,8455,18,71,474.84,17.8
"2011","Manchester 005","E02001049","Total",9633,4609,5024,9520,113,67,215.55,44.7
"2011","Manchester 006","E02001050","Total",7166,3673,3493,7072,94,42,167.25,42.8
"2011","Manchester 007","E02001051","Total",8038,3947,4091,7975,63,62,135.70,59.2
"2011","Manchester 008","E02001052","Total",12771,6618,6153,12588,183,74,202.03,63.2
"2011","Manchester 009","E02001053","Total",10042,5035,5007,9950,92,54,273.39,36.7
"2011","Manchester 011","E02001055","Total",8601,4176,4425,8434,167,49,342.58,25.1
"2011","Manchester 012","E02001056","Total",8169,3906,4263,8119,50,40,182.28,44.8
"2011","Manchester 013","E02001057","Total",8107,4347,3760,8028,79,36,234.84,34.5
"2011","Manchester 015","E02001059","Total",9802,4926,4876,9772,30,41,368.63,26.6
"2011","Manchester 017","E02001061","Total",9002,4415,4587,8907,95,55,192.91,46.7
"2011","Manchester 018","E02001062","Total",9958,5172,4786,8178,1780,95,258.51,38.5
"2011","Manchester 019","E02001063","Total",10560,5480,5080,7682,2878,93,171.31,61.6
"2011","Manchester 020","E02001064","Total",9127,4552,4575,8994,133,75,260.48,35.0
"2011","Manchester 021","E02001065","Total",8679,4356,4323,8658,21,52,192.26,45.1
"2011","Manchester 022","E02001066","Total",11925,6225,5700,9775,2150,96,113.03,105.5
"2011","Manchester 023","E02001067","Total",9514,4696,4818,9495,19,52,171.67,55.4
"2011","Manchester 024","E02001068","Total",9667,4599,5068,9667,0,66,126.16,76.6
"2011","Manchester 025","E02001069","Total",10996,5852,5144,10654,342,56,87.42,125.8
"2011","Manchester 026","E02001070","Total",11895,5986,5909,8802,3093,143,154.16,77.2
"2011","Manchester 027","E02001071","Total",13251,6866,6385,13199,52,81,143.10,92.6
"2011","Manchester 028","E02001072","Total",8606,4487,4119,8426,180,52,108.96,79.0
"2011","Manchester 029","E02001073","Total",9688,4946,4742,9555,133,102,133.01,72.8
"2011","Manchester 030","E02001074","Total",11579,5692,5887,11296,283,94,193.98,59.7
"2011","Manchester 031","E02001075","Total",8272,4283,3989,8199,73,59,118.13,70.0
"2011","Manchester 032","E02001076","Total",11579,5732,5847,9186,2393,149,135.86,85.2
"2011","Manchester 033","E02001077","Total",7750,3739,4011,7745,5,91,129.53,59.8
"2011","Manchester 034","E02001078","Total",10474,5148,5326,10462,12,92,165.15,63.4
"2011","Manchester 035","E02001079","Total",8982,4359,4623,8961,21,71,170.07,52.8
"2011","Manchester 036","E02001080","Total",9532,4749,4783,9509,23,86,102.58,92.9
"2011","Manchester 037","E02001081","Total",6213,2926,3287,6213,0,69,221.71,28.0
"2011","Manchester 038","E02001082","Total",6792,3491,3301,6706,86,65,88.81,76.5
"2011","Manchester 039","E02001083","Total",7924,4020,3904,7813,111,31,142.30,55.7
"2011","Manchester 040","E02001084","Total",8620,4423,4197,8600,20,94,137.73,62.6
"2011","Manchester 041","E02001085","Total",8241,3849,4392,8241,0,55,135.76,60.7
"2011","Manchester 042","E02001086","Total",6594,3196,3398,6490,104,74,210.15,31.4
"2011","Manchester 043","E02001087","Total",9467,4663,4804,9410,57,133,203.11,46.6
"2011","Manchester 044","E02001088","Total",8891,4305,4586,8822,69,55,166.14,53.5
"2011","Manchester 045","E02001089","Total",8017,3960,4057,7852,165,125,262.27,30.6
"2011","Manchester 046","E02001090","Total",6686,3297,3389,6650,36,61,376.45,17.8
"2011","Manchester 047","E02001091","Total",8157,3906,4251,8137,20,73,182.18,44.8
"2011","Manchester 048","E02001092","Total",8506,4210,4296,8485,21,37,278.77,30.5
"2011","Manchester 049","E02001093","Total",9207,4450,4757,9008,199,26,196.16,46.9
"2011","Manchester 050","E02001094","Total",9001,4197,4804,9001,0,33,165.87,54.3
"2011","Manchester 051","E02001095","Total",8303,3946,4357,8225,78,32,286.92,28.9
"2011","Manchester 052","E02001096","Total",7395,3590,3805,7394,1,32,328.86,22.5
"2011","Manchester 053","E02001097","Total",8054,3869,4185,7988,66,26,843.71,9.5
"2011","Manchester 054","E02006902","Total",6061,3339,2722,5725,336,49,164.42,36.9
"2011","Manchester 055","E02006912","Total",8827,4856,3971,6581,2246,77,146.54,60.2
"2011","Manchester 056","E02006913","Total",6679,3579,3100,6669,10,48,171.92,38.8
"2011","Manchester 057","E02006914","Total",6935,3775,3160,3978,2957,104,63.27,109.6
"2011","Manchester 058","E02006915","Total",8720,4712,4008,7906,814,62,180.46,48.3
"2011","Manchester 059","E02006916","Total",5749,3219,2530,5749,0,29,64.90,88.6
"2011","Manchester 060","E02006917","Total",5063,2987,2076,5062,1,37,96.97,52.2
"2011","Oldham 001","E02001098","Total",6063,2920,3143,6063,0,53,371.97,16.3
"2011","Oldham 002","E02001099","Total",6041,2881,3160,6041,0,59,152.10,39.7
"2011","Oldham 003","E02001100","Total",6115,2946,3169,5992,123,98,617.96,9.9
"2011","Oldham 004","E02001101","Total",5976,2919,3057,5968,8,73,290.83,20.5
"2011","Oldham 005","E02001102","Total",6114,3023,3091,6095,19,82,163.28,37.4
"2011","Oldham 006","E02001103","Total",5541,2737,2804,5541,0,116,3426.90,1.6
"2011","Oldham 007","E02001104","Total",6939,3364,3575,6864,75,78,391.38,17.7
"2011","Oldham 008","E02001105","Total",5997,2923,3074,5957,40,62,257.43,23.3
"2011","Oldham 009","E02001106","Total",6043,2911,3132,5934,109,46,251.49,24.0
"2011","Oldham 010","E02001107","Total",6150,3019,3131,6150,0,75,261.44,23.5
"2011","Oldham 011","E02001108","Total",5082,2454,2628,4994,88,31,147.67,34.4
"2011","Oldham 012","E02001109","Total",7314,3620,3694,7252,62,67,162.84,44.9
"2011","Oldham 013","E02001110","Total",6244,3112,3132,6177,67,129,1131.19,5.5
"2011","Oldham 014","E02001111","Total",6679,3342,3337,6638,41,40,178.18,37.5
"2011","Oldham 015","E02001112","Total",5938,2994,2944,5938,0,80,350.17,17.0
"2011","Oldham 016","E02001113","Total",9536,4814,4722,9499,37,68,157.93,60.4
"2011","Oldham 017","E02001114","Total",8150,3992,4158,8016,134,53,190.78,42.7
"2011","Oldham 018","E02001115","Total",5956,2924,3032,5881,75,74,140.84,42.3
"2011","Oldham 019","E02001116","Total",6462,3202,3260,6405,57,35,121.58,53.2
"2011","Oldham 020","E02001117","Total",5906,2887,3019,5906,0,123,2752.85,2.1
"2011","Oldham 021","E02001118","Total",6259,3005,3254,6234,25,121,274.76,22.8
"2011","Oldham 022","E02001119","Total",10850,5347,5503,10597,253,62,179.91,60.3
"2011","Oldham 024","E02001121","Total",6519,3281,3238,6490,29,37,131.67,49.5
"2011","Oldham 026","E02001123","Total",6449,3081,3368,6423,26,38,330.81,19.5
"2011","Oldham 027","E02001124","Total",5739,2740,2999,5725,14,37,98.20,58.4
"2011","Oldham 028","E02001125","Total",8038,3984,4054,7990,48,65,243.15,33.1
"2011","Oldham 029","E02001126","Total",7465,3632,3833,7419,46,36,204.19,36.6
"2011","Oldham 030","E02001127","Total",7080,3338,3742,7080,0,52,157.96,44.8
"2011","Oldham 031","E02001128","Total",7460,3600,3860,7458,2,33,173.18,43.1
"2011","Oldham 032","E02001129","Total",5801,2799,3002,5704,97,31,158.52,36.6
"2011","Oldham 033","E02001130","Total",5778,2769,3009,5739,39,45,484.78,11.9
"2011","Oldham 034","E02001131","Total",5304,2578,2726,5304,0,36,106.30,49.9
"2011","Oldham 035","E02006860","Total",13909,7017,6892,13696,213,83,174.25,79.8
"2011","Rochdale 001","E02001132","Total",6463,3159,3304,6406,57,57,1024.11,6.3
"2011","Rochdale 002","E02001133","Total",6175,3043,3132,6175,0,66,1298.49,4.8
"2011","Rochdale 003","E02001134","Total",6271,3038,3233,6113,158,57,1834.62,3.4
"2011","Rochdale 004","E02001135","Total",7607,3697,3910,7539,68,39,160.85,47.3
"2011","Rochdale 005","E02001136","Total",9189,4574,4615,8753,436,126,354.53,25.9
"2011","Rochdale 006","E02001137","Total",6198,3055,3143,6198,0,112,2794.22,2.2
"2011","Rochdale 007","E02001138","Total",8945,4343,4602,8883,62,212,350.90,25.5
"2011","Rochdale 008","E02001139","Total",9257,4668,4589,9244,13,49,183.82,50.4
"2011","Rochdale 009","E02001140","Total",7564,3632,3932,7451,113,66,204.85,36.9
"2011","Rochdale 010","E02001141","Total",12440,6453,5987,12246,194,74,298.14,41.7
"2011","Rochdale 011","E02001142","Total",5925,2894,3031,5844,81,143,277.05,21.4
"2011","Rochdale 012","E02001143","Total",10636,5199,5437,10580,56,83,217.03,49.0
"2011","Rochdale 013","E02001144","Total",6135,3014,3121,6103,32,49,371.68,16.5
"2011","Rochdale 014","E02001145","Total",7109,3478,3631,7077,32,74,1670.76,4.3
"2011","Rochdale 015","E02001146","Total",9132,4558,4574,9041,91,65,151.73,60.2
"2011","Rochdale 016","E02001147","Total",9047,4383,4664,9029,18,87,465.90,19.4
"2011","Rochdale 017","E02001148","Total",10016,4756,5260,9806,210,77,588.65,17.0
"2011","Rochdale 018","E02001149","Total",9683,4722,4961,9674,9,50,243.23,39.8
"2011","Rochdale 019","E02001150","Total",8490,4087,4403,8418,72,63,481.20,17.6
"2011","Rochdale 020","E02001151","Total",9414,4572,4842,9258,156,141,853.39,11.0
"2011","Rochdale 021","E02001152","Total",9098,4407,4691,9029,69,93,696.07,13.1
"2011","Rochdale 022","E02001153","Total",9998,4735,5263,9947,51,39,475.52,21.0
"2011","Rochdale 023","E02001154","Total",10226,5065,5161,10163,63,72,213.34,47.9
"2011","Rochdale 024","E02001155","Total",6965,3453,3512,6859,106,61,321.32,21.7
"2011","Rochdale 025","E02001156","Total",9716,4657,5059,9716,0,128,276.67,35.1
"2011","Salford 001","E02001157","Total",7247,3475,3772,7225,22,34,204.86,35.4
"2011","Salford 002","E02001158","Total",5934,2885,3049,5895,39,25,120.71,49.2
"2011","Salford 003","E02001159","Total",5713,2784,2929,5706,7,34,326.12,17.5
"2011","Salford 004","E02001160","Total",6208,2941,3267,6199,9,48,257.83,24.1
"2011","Salford 005","E02001161","Total",5848,2807,3041,5848,0,34,254.67,23.0
"2011","Salford 006","E02001162","Total",5808,2908,2900,5782,26,26,166.13,35.0
"2011","Salford 007","E02001163","Total",9310,4550,4760,9273,37,95,310.48,30.0
"2011","Salford 008","E02001164","Total",7114,3941,3173,6257,857,27,436.12,16.3
"2011","Salford 009","E02001165","Total",6147,2955,3192,6147,0,29,192.00,32.0
"2011","Salford 010","E02001166","Total",6997,3475,3522,6799,198,341,127.90,54.7
"2011","Salford 011","E02001167","Total",6354,3019,3335,6158,196,70,204.25,31.1
"2011","Salford 012","E02001168","Total",9406,4545,4861,9291,115,64,266.27,35.3
"2011","Salford 013","E02001169","Total",10546,5209,5337,10513,33,177,1116.13,9.4
"2011","Salford 014","E02001170","Total",9692,4724,4968,9644,48,142,635.09,15.3
"2011","Salford 015","E02001171","Total",5594,2706,2888,5567,27,44,107.15,52.2
"2011","Salford 016","E02001172","Total",11945,6075,5870,11658,287,104,174.82,68.3
"2011","Salford 017","E02001173","Total",8362,4216,4146,6793,1569,92,286.26,29.2
"2011","Salford 018","E02001174","Total",5640,2794,2846,5472,168,50,101.67,55.5
"2011","Salford 019","E02001175","Total",6938,3346,3592,6936,2,44,152.48,45.5
"2011","Salford 020","E02001176","Total",10930,5491,5439,10759,171,121,262.52,41.6
"2011","Salford 021","E02001177","Total",11657,5636,6021,11521,136,74,352.78,33.0
"2011","Salford 022","E02001178","Total",10658,6004,4654,9892,766,67,326.66,32.6
"2011","Salford 023","E02001179","Total",5799,2988,2811,5795,4,27,91.23,63.6
"2011","Salford 024","E02001180","Total",5878,3122,2756,5218,660,34,91.26,64.4
"2011","Salford 025","E02001181","Total",5690,2819,2871,5647,43,23,298.15,19.1
"2011","Salford 026","E02001182","Total",6003,3016,2987,5909,94,26,119.86,50.1
"2011","Salford 027","E02001183","Total",6044,2958,3086,6001,43,33,200.19,30.2
"2011","Salford 028","E02001184","Total",10404,5601,4803,10404,0,38,308.33,33.7
"2011","Salford 029","E02001185","Total",10104,4899,5205,10074,30,69,867.74,11.6
"2011","Salford 030","E02001186","Total",9963,4893,5070,9963,0,53,1359.36,7.3
"2011","Stockport 001","E02001187","Total",7188,3427,3761,7188,0,57,108.20,66.4
"2011","Stockport 002","E02001188","Total",7941,3853,4088,7915,26,48,168.55,47.1
"2011","Stockport 003","E02001189","Total",8382,4059,4323,8382,0,78,225.44,37.2
"2011","Stockport 004","E02001190","Total",6686,3278,3408,6607,79,23,196.84,34.0
"2011","Stockport 005","E02001191","Total",5841,2933,2908,5812,29,59,188.28,31.0
"2011","Stockport 006","E02001192","Total",6446,3249,3197,6304,142,115,142.18,45.3
"2011","Stockport 007","E02001193","Total",6099,3056,3043,6067,32,41,198.11,30.8
"2011","Stockport 008","E02001194","Total",5886,2904,2982,5754,132,136,186.40,31.6
"2011","Stockport 009","E02001195","Total",7449,3642,3807,7361,88,54,432.40,17.2
"2011","Stockport 010","E02001196","Total",7547,3689,3858,7535,12,88,734.84,10.3
"2011","Stockport 011","E02001197","Total",6225,2979,3246,6219,6,88,178.50,34.9
"2011","Stockport 012","E02001198","Total",7545,3649,3896,7458,87,58,371.99,20.3
"2011","Stockport 013","E02001199","Total",7806,3824,3982,7777,29,112,208.93,37.4
"2011","Stockport 014","E02001200","Total",6421,3447,2974,6263,158,44,260.27,24.7
"2011","Stockport 015","E02001201","Total",5784,2833,2951,5749,35,59,155.98,37.1
"2011","Stockport 016","E02001202","Total",6094,3011,3083,6064,30,21,116.84,52.2
"2011","Stockport 017","E02001203","Total",5796,2841,2955,5777,19,117,1658.20,3.5
"2011","Stockport 018","E02001204","Total",8938,4334,4604,8875,63,57,199.31,44.8
"2011","Stockport 019","E02001205","Total",7783,3908,3875,7753,30,42,167.38,46.5
"2011","Stockport 020","E02001206","Total",7003,3298,3705,6792,211,109,374.39,18.7
"2011","Stockport 021","E02001207","Total",7013,3486,3527,6989,24,88,337.92,20.8
"2011","Stockport 022","E02001208","Total",7222,3437,3785,7222,0,41,271.28,26.6
"2011","Stockport 023","E02001209","Total",7734,3782,3952,7593,141,75,132.07,58.6
"2011","Stockport 024","E02001210","Total",6901,3319,3582,6832,69,44,155.04,44.5
"2011","Stockport 025","E02001211","Total",6010,2864,3146,5941,69,90,199.61,30.1
"2011","Stockport 026","E02001212","Total",6492,3185,3307,6440,52,41,151.07,43.0
"2011","Stockport 027","E02001213","Total",9129,4496,4633,8969,160,141,245.54,37.2
"2011","Stockport 028","E02001214","Total",7452,3609,3843,7423,29,138,276.63,26.9
"2011","Stockport 029","E02001215","Total",5804,2785,3019,5731,73,68,596.81,9.7
"2011","Stockport 030","E02001216","Total",7310,3571,3739,7276,34,118,256.07,28.5
"2011","Stockport 031","E02001217","Total",6581,3188,3393,6567,14,68,177.00,37.2
"2011","Stockport 032","E02001218","Total",5860,2842,3018,5833,27,160,318.83,18.4
"2011","Stockport 033","E02001219","Total",5455,2644,2811,5452,3,111,196.00,27.8
"2011","Stockport 034","E02001220","Total",5536,2688,2848,5525,11,124,176.41,31.4
"2011","Stockport 035","E02001221","Total",6003,2925,3078,5936,67,115,181.66,33.0
"2011","Stockport 036","E02001222","Total",6206,3044,3162,6146,60,89,233.14,26.6
"2011","Stockport 037","E02001223","Total",6893,3343,3550,6795,98,201,340.68,20.2
"2011","Stockport 038","E02001224","Total",5816,2831,2985,5775,41,78,675.43,8.6
"2011","Stockport 039","E02001225","Total",7078,3440,3638,7075,3,158,255.15,27.7
"2011","Stockport 040","E02001226","Total",6810,3353,3457,6744,66,80,243.05,28.0
"2011","Stockport 041","E02001227","Total",5699,2755,2944,5680,19,157,175.56,32.5
"2011","Stockport 042","E02001228","Total",5411,2599,2812,5319,92,131,738.20,7.3
"2011","Tameside 001","E02001229","Total",9731,4759,4972,9647,84,96,509.55,19.1
"2011","Tameside 002","E02001230","Total",6147,3044,3103,6147,0,100,579.42,10.6
"2011","Tameside 003","E02001231","Total",7150,3528,3622,7150,0,54,729.25,9.8
"2011","Tameside 004","E02001232","Total",8211,4021,4190,8120,91,51,152.16,54.0
"2011","Tameside 005","E02001233","Total",7541,3657,3884,7455,86,69,234.72,32.1
"2011","Tameside 006","E02001234","Total",7615,3699,3916,7511,104,53,131.23,58.0
"2011","Tameside 007","E02001235","Total",6559,3353,3206,6440,119,62,173.57,37.8
"2011","Tameside 008","E02001236","Total",5734,2806,2928,5635,99,26,139.63,41.1
"2011","Tameside 009","E02001237","Total",6855,3306,3549,6740,115,55,1502.79,4.6
"2011","Tameside 010","E02001238","Total",7773,3800,3973,7740,33,75,228.09,34.1
"2011","Tameside 011","E02001239","Total",9077,4335,4742,9033,44,66,192.78,47.1
"2011","Tameside 012","E02001240","Total",6184,3047,3137,6184,0,52,109.61,56.4
"2011","Tameside 013","E02001241","Total",9483,4937,4546,9441,42,34,347.24,27.3
"2011","Tameside 014","E02001242","Total",5707,2770,2937,5657,50,62,304.06,18.8
"2011","Tameside 015","E02001243","Total",7872,4015,3857,7854,18,120,469.09,16.8
"2011","Tameside 016","E02001244","Total",5511,2732,2779,5495,16,37,163.97,33.6
"2011","Tameside 017","E02001245","Total",7848,3884,3964,7779,69,47,262.79,29.9
"2011","Tameside 018","E02001246","Total",7289,3576,3713,7189,100,39,165.38,44.1
"2011","Tameside 019","E02001247","Total",6926,3397,3529,6868,58,51,171.84,40.3
"2011","Tameside 020","E02001248","Total",10258,5072,5186,10252,6,61,295.76,34.7
"2011","Tameside 021","E02001249","Total",6269,3070,3199,6269,0,63,143.59,43.7
"2011","Tameside 022","E02001250","Total",6514,3164,3350,6470,44,68,392.89,16.6
"2011","Tameside 023","E02001251","Total",6021,2966,3055,5995,26,74,817.87,7.4
"2011","Tameside 024","E02001252","Total",7491,3629,3862,7488,3,63,243.21,30.8
"2011","Tameside 025","E02001253","Total",5189,2481,2708,5161,28,33,305.56,17.0
"2011","Tameside 026","E02001254","Total",5823,2803,3020,5796,27,42,134.15,43.4
"2011","Tameside 027","E02001255","Total",6071,2953,3118,6071,0,29,351.03,17.3
"2011","Tameside 028","E02001256","Total",10137,4992,5145,9939,198,47,233.78,43.4
"2011","Tameside 029","E02001257","Total",9106,4385,4721,9053,53,65,251.91,36.1
"2011","Tameside 030","E02001258","Total",7232,3469,3763,7157,75,75,580.22,12.5
"2011","Trafford 001","E02001259","Total",10177,5135,5042,10145,32,76,178.52,57.0
"2011","Trafford 002","E02001260","Total",7632,3689,3943,7598,34,79,670.53,11.4
"2011","Trafford 003","E02001261","Total",8277,4168,4109,8267,10,72,212.93,38.9
"2011","Trafford 004","E02001262","Total",8461,4127,4334,8433,28,93,160.74,52.6
"2011","Trafford 005","E02001263","Total",8054,3974,4080,8000,54,117,358.99,22.4
"2011","Trafford 006","E02001264","Total",8149,3897,4252,8149,0,74,400.09,20.4
"2011","Trafford 007","E02001265","Total",8108,3941,4167,8108,0,70,344.89,23.5
"2011","Trafford 008","E02001266","Total",6649,3261,3388,6629,20,66,341.31,19.5
"2011","Trafford 009","E02001267","Total",7422,3594,3828,7252,170,56,266.68,27.8
"2011","Trafford 010","E02001268","Total",7196,3458,3738,7060,136,103,191.51,37.6
"2011","Trafford 011","E02001269","Total",8266,4096,4170,8240,26,84,244.76,33.8
"2011","Trafford 012","E02001270","Total",7861,3912,3949,7849,12,98,200.20,39.3
"2011","Trafford 013","E02001271","Total",6547,3176,3371,6547,0,62,232.68,28.1
"2011","Trafford 014","E02001272","Total",7850,3913,3937,7821,29,116,226.31,34.7
"2011","Trafford 015","E02001273","Total",8882,4442,4440,8798,84,119,187.55,47.4
"2011","Trafford 016","E02001274","Total",7874,3834,4040,7782,92,214,199.38,39.5
"2011","Trafford 017","E02001275","Total",8395,3976,4419,8360,35,50,1202.38,7.0
"2011","Trafford 018","E02001276","Total",7931,3804,4127,7931,0,87,235.32,33.7
"2011","Trafford 019","E02001277","Total",8823,4267,4556,8822,1,71,300.28,29.4
"2011","Trafford 020","E02001278","Total",8117,4067,4050,8101,16,151,155.71,52.1
"2011","Trafford 021","E02001279","Total",8426,4245,4181,8397,29,182,172.50,48.8
"2011","Trafford 022","E02001280","Total",8268,3915,4353,8237,31,105,179.64,46.0
"2011","Trafford 023","E02001281","Total",7753,3795,3958,7737,16,160,248.41,31.2
"2011","Trafford 024","E02001282","Total",9008,4504,4504,8968,40,138,188.76,47.7
"2011","Trafford 025","E02001283","Total",8645,4246,4399,8456,189,175,2186.95,4.0
"2011","Trafford 026","E02001284","Total",8082,3954,4128,8082,0,282,209.21,38.6
"2011","Trafford 027","E02001285","Total",7831,3802,4029,7679,152,239,400.67,19.5
"2011","Trafford 028","E02001286","Total",7894,3767,4127,7829,65,296,706.83,11.2
"2011","Wigan 001","E02001287","Total",5685,2802,2883,5671,14,82,487.69,11.7
"2011","Wigan 002","E02001288","Total",7547,3697,3850,7477,70,138,604.91,12.5
"2011","Wigan 003","E02001289","Total",10082,5035,5047,10082,0,107,745.96,13.5
"2011","Wigan 004","E02001290","Total",6086,2979,3107,6040,46,86,1416.56,4.3
"2011","Wigan 005","E02001291","Total",7675,3755,3920,7666,9,34,246.70,31.1
"2011","Wigan 006","E02001292","Total",7864,3927,3937,7795,69,124,234.57,33.5
"2011","Wigan 007","E02001293","Total",6158,3076,3082,6137,21,53,578.50,10.6
"2011","Wigan 008","E02001294","Total",7832,3962,3870,7767,65,76,170.18,46.0
"2011","Wigan 009","E02001295","Total",7330,3803,3527,7279,51,21,131.06,55.9
"2011","Wigan 010","E02001296","Total",8933,4386,4547,8878,55,24,338.83,26.4
"2011","Wigan 011","E02001297","Total",6703,3321,3382,6637,66,36,363.13,18.5
"2011","Wigan 012","E02001298","Total",8131,4056,4075,8054,77,35,525.77,15.5
"2011","Wigan 013","E02001299","Total",8850,4358,4492,8722,128,63,459.84,19.2
"2011","Wigan 014","E02001300","Total",7922,3965,3957,7794,128,43,167.33,47.3
"2011","Wigan 015","E02001301","Total",8099,4039,4060,7972,127,28,337.03,24.0
"2011","Wigan 016","E02001302","Total",7846,3861,3985,7804,42,39,179.29,43.8
"2011","Wigan 017","E02001303","Total",8530,4324,4206,8475,55,51,228.62,37.3
"2011","Wigan 018","E02001304","Total",12240,5999,6241,12240,0,128,1073.52,11.4
"2011","Wigan 019","E02001305","Total",8197,4021,4176,8160,37,69,256.92,31.9
"2011","Wigan 020","E02001306","Total",7302,3636,3666,7302,0,60,275.89,26.5
"2011","Wigan 021","E02001307","Total",11264,5594,5670,11264,0,92,620.30,18.2
"2011","Wigan 022","E02001308","Total",5992,2978,3014,5913,79,61,222.59,26.9
"2011","Wigan 023","E02001309","Total",7669,3851,3818,7647,22,46,494.30,15.5
"2011","Wigan 024","E02001310","Total",8988,4467,4521,8915,73,42,656.91,13.7
"2011","Wigan 025","E02001311","Total",8317,4113,4204,8307,10,70,370.13,22.5
"2011","Wigan 026","E02001312","Total",7790,4043,3747,7571,219,28,800.39,9.7
"2011","Wigan 027","E02001313","Total",7893,3908,3985,7816,77,58,271.52,29.1
"2011","Wigan 028","E02001314","Total",8026,4084,3942,8026,0,81,218.22,36.8
"2011","Wigan 029","E02001315","Total",7689,3765,3924,7689,0,75,1778.01,4.3
"2011","Wigan 030","E02001316","Total",6546,3302,3244,6525,21,37,118.81,55.1
"2011","Wigan 031","E02001317","Total",8444,4238,4206,8229,215,79,370.69,22.8
"2011","Wigan 032","E02001318","Total",7869,3922,3947,7869,0,68,425.65,18.5
"2011","Wigan 033","E02001319","Total",7356,3646,3710,7323,33,40,452.02,16.3
"2011","Wigan 034","E02001320","Total",7663,3723,3940,7663,0,58,291.67,26.3
"2011","Wigan 035","E02001321","Total",8398,4214,4184,8350,48,63,530.11,15.8
"2011","Wigan 036","E02001322","Total",7448,3666,3782,7344,104,91,192.31,38.7
"2011","Wigan 037","E02001323","Total",7535,3662,3873,7535,0,91,386.99,19.5
"2011","Wigan 038","E02001324","Total",8473,4202,4271,8436,37,62,281.75,30.1
"2011","Wigan 039","E02001325","Total",7775,3802,3973,7718,57,85,907.92,8.6
"2011","Wigan 040","E02001326","Total",7702,3814,3888,7702,0,77,606.56,12.7
"2011","Burnley 001","E02005176","Total",8832,4246,4586,8776,56,94,210.96,41.9
"2011","Burnley 002","E02005177","Total",5797,2839,2958,5674,123,33,142.04,40.8
"2011","Burnley 003","E02005178","Total",8945,4663,4282,8894,51,91,293.72,30.5
"2011","Burnley 004","E02005179","Total",8907,4342,4565,8802,105,82,409.70,21.7
"2011","Burnley 005","E02005180","Total",7006,3426,3580,6909,97,105,564.32,12.4
"2011","Burnley 006","E02005181","Total",6181,3019,3162,6146,35,40,130.20,47.5
"2011","Burnley 007","E02005182","Total",5875,2855,3020,5767,108,42,164.26,35.8
"2011","Burnley 008","E02005183","Total",6086,2964,3122,6079,7,61,277.50,21.9
"2011","Burnley 009","E02005184","Total",5024,2500,2524,5009,15,64,5716.27,0.9
"2011","Burnley 010","E02005185","Total",8408,4126,4282,8319,89,49,297.03,28.3
"2011","Burnley 011","E02005186","Total",6037,2992,3045,5986,51,80,2515.79,2.4
"2011","Burnley 014","E02006881","Total",9961,4822,5139,9756,205,121,348.24,28.6
"2011","Chorley 001","E02005189","Total",5300,2669,2631,5138,162,39,151.06,35.1
"2011","Chorley 002","E02005190","Total",6234,3026,3208,6173,61,127,4300.09,1.4
"2011","Chorley 003","E02005191","Total",8320,4110,4210,8237,83,118,588.95,14.1
"2011","Chorley 004","E02005192","Total",7347,3659,3688,7312,35,105,2275.79,3.2
"2011","Chorley 005","E02005193","Total",8487,4146,4341,8422,65,126,884.14,9.6
"2011","Chorley 006","E02005194","Total",8139,4000,4139,8034,105,87,461.11,17.7
"2011","Chorley 007","E02005195","Total",7720,4731,2989,5793,1927,100,3483.25,2.2
"2011","Chorley 008","E02005196","Total",7438,3617,3821,7303,135,93,575.79,12.9
"2011","Chorley 009","E02005197","Total",6823,3279,3544,6792,31,46,309.99,22.0
"2011","Chorley 010","E02005198","Total",8181,4169,4012,8170,11,78,389.38,21.0
"2011","Chorley 011","E02005199","Total",7149,3560,3589,7137,12,95,2806.71,2.5
"2011","Chorley 012","E02005200","Total",8597,4198,4399,8542,55,59,289.99,29.6
"2011","Chorley 013","E02005201","Total",7959,3899,4060,7846,113,67,971.43,8.2
"2011","Chorley 014","E02005202","Total",9461,4645,4816,9378,83,104,2792.01,3.4
"2011","Fylde 001","E02005203","Total",7158,3508,3650,7077,81,145,6614.94,1.1
"2011","Fylde 002","E02005204","Total",10318,4967,5351,10217,101,149,1448.52,7.1
"2011","Fylde 003","E02005205","Total",6859,3599,3260,6279,580,82,4221.28,1.6
"2011","Fylde 004","E02005206","Total",6816,3278,3538,6756,60,82,516.66,13.2
"2011","Fylde 005","E02005207","Total",8057,3806,4251,8044,13,132,644.70,12.5
"2011","Fylde 006","E02005208","Total",9955,4969,4986,9581,374,157,281.63,35.3
"2011","Fylde 007","E02005209","Total",7816,3800,4016,7763,53,93,1782.06,4.4
"2011","Fylde 008","E02005210","Total",10232,4847,5385,9925,307,193,420.82,24.3
"2011","Fylde 009","E02005211","Total",8546,4007,4539,8393,153,127,638.25,13.4
"2011","Hyndburn 001","E02005212","Total",10800,5324,5476,10752,48,105,1221.88,8.8
"2011","Hyndburn 002","E02005213","Total",11714,5764,5950,11559,155,122,1186.55,9.9
"2011","Hyndburn 003","E02005214","Total",6625,3296,3329,6623,2,53,1107.97,6.0
"2011","Hyndburn 004","E02005215","Total",11836,5801,6035,11659,177,85,415.24,28.5
"2011","Hyndburn 005","E02005216","Total",5398,2630,2768,5386,12,39,323.46,16.7
"2011","Hyndburn 006","E02005217","Total",12126,5996,6130,12034,92,69,237.17,51.1
"2011","Hyndburn 007","E02005218","Total",7450,3696,3754,7379,71,57,168.75,44.1
"2011","Hyndburn 008","E02005219","Total",8466,4274,4192,8413,53,99,866.54,9.8
"2011","Hyndburn 009","E02005220","Total",6319,3196,3123,6283,36,43,1771.76,3.6
"2011","Lancaster 001","E02005221","Total",9955,4791,5164,9806,149,118,5085.64,2.0
"2011","Lancaster 002","E02005222","Total",6009,2991,3018,5880,129,125,26509.39,0.2
"2011","Lancaster 003","E02005223","Total",7253,3443,3810,7091,162,118,1533.86,4.7
"2011","Lancaster 004","E02005224","Total",5190,2331,2859,4961,229,51,176.85,29.3
"2011","Lancaster 005","E02005225","Total",5231,2513,2718,5198,33,90,4783.62,1.1
"2011","Lancaster 006","E02005226","Total",7813,3834,3979,7581,232,35,143.90,54.3
"2011","Lancaster 008","E02005228","Total",5789,2785,3004,5681,108,49,115.63,50.1
"2011","Lancaster 009","E02005229","Total",5631,2854,2777,5485,146,39,65.91,85.4
"2011","Lancaster 010","E02005230","Total",6565,3054,3511,6538,27,45,304.79,21.5
"2011","Lancaster 011","E02005231","Total",8007,3851,4156,8000,7,74,163.88,48.9
"2011","Lancaster 013","E02005233","Total",6069,3072,2997,5692,377,93,424.48,14.3
"2011","Lancaster 014","E02005234","Total",7546,3891,3655,6871,675,99,154.98,48.7
"2011","Lancaster 015","E02005235","Total",5367,2528,2839,4984,383,67,65.47,82.0
"2011","Lancaster 016","E02005236","Total",12755,6182,6573,12691,64,116,2791.14,4.6
"2011","Lancaster 017","E02005237","Total",9839,4610,5229,9288,551,221,830.84,11.8
"2011","Lancaster 018","E02005238","Total",5739,2697,3042,5714,25,74,124.17,46.2
"2011","Lancaster 019","E02005239","Total",11690,5673,6017,6108,5582,207,13945.35,0.8
"2011","Lancaster 020","E02006871","Total",11927,5741,6186,11864,63,140,365.74,32.6
"2011","Pendle 001","E02005240","Total",5445,2679,2766,5401,44,56,412.42,13.2
"2011","Pendle 002","E02005241","Total",5551,2768,2783,5514,37,48,1877.66,3.0
"2011","Pendle 003","E02005242","Total",6183,3039,3144,6180,3,68,2118.98,2.9
"2011","Pendle 004","E02005243","Total",5089,2463,2626,5022,67,31,167.35,30.4
"2011","Pendle 005","E02005244","Total",5827,2805,3022,5750,77,50,383.31,15.2
"2011","Pendle 006","E02005245","Total",6945,3417,3528,6924,21,88,5075.20,1.4
"2011","Pendle 007","E02005246","Total",5180,2598,2582,5153,27,39,377.87,13.7
"2011","Pendle 008","E02005247","Total",9944,4831,5113,9861,83,160,4512.93,2.2
"2011","Pendle 009","E02005248","Total",6489,3173,3316,6466,23,47,161.68,40.1
"2011","Pendle 010","E02005249","Total",9452,4711,4741,9405,47,63,141.10,67.0
"2011","Pendle 011","E02005250","Total",7702,3814,3888,7702,0,90,152.55,50.5
"2011","Pendle 012","E02005251","Total",6916,3344,3572,6807,109,75,815.06,8.5
"2011","Pendle 013","E02005252","Total",8729,4370,4359,8661,68,104,740.26,11.8
"2011","Preston 001","E02005253","Total",5886,2881,3005,5798,88,115,5961.74,1.0
"2011","Preston 002","E02005254","Total",6372,3121,3251,6353,19,159,3792.36,1.7
"2011","Preston 003","E02005255","Total",8865,4275,4590,8840,25,146,227.12,39.0
"2011","Preston 004","E02005256","Total",7058,3477,3581,6888,170,118,433.30,16.3
"2011","Preston 005","E02005257","Total",5951,2877,3074,5827,124,58,152.45,39.0
"2011","Preston 006","E02005258","Total",8070,3963,4107,7961,109,142,276.90,29.1
"2011","Preston 007","E02005259","Total",10244,4935,5309,10109,135,58,274.64,37.3
"2011","Preston 008","E02005260","Total",6837,3354,3483,6708,129,84,181.99,37.6
"2011","Preston 009","E02005261","Total",10003,4978,5025,9939,64,61,627.85,15.9
"2011","Preston 010","E02005262","Total",6197,3190,3007,6163,34,96,943.57,6.6
"2011","Preston 011","E02005263","Total",7093,3641,3452,6962,131,36,127.40,55.7
"2011","Preston 012","E02005264","Total",12533,6171,6362,10768,1765,133,196.90,63.7
"2011","Preston 013","E02005265","Total",10850,5360,5490,10770,80,77,257.07,42.2
"2011","Preston 014","E02005266","Total",8187,4460,3727,7614,573,38,120.31,68.0
"2011","Preston 015","E02005267","Total",6892,3537,3355,5091,1801,92,82.77,83.3
"2011","Preston 016","E02005268","Total",9270,4631,4639,9230,40,41,354.83,26.1
"2011","Preston 017","E02005269","Total",9894,5433,4461,9371,523,83,218.20,45.3
"2011","Ribble Valley 001","E02005270","Total",7400,3712,3688,7006,394,185,28244.39,0.3
"2011","Ribble Valley 002","E02005271","Total",7540,3674,3866,7446,94,141,709.50,10.6
"2011","Ribble Valley 003","E02005272","Total",7225,3516,3709,7130,95,69,254.52,28.4
"2011","Ribble Valley 004","E02005273","Total",5751,2814,2937,5674,77,107,14838.73,0.4
"2011","Ribble Valley 005","E02005274","Total",6627,3213,3414,6573,54,121,6119.50,1.1
"2011","Ribble Valley 006","E02005275","Total",5392,2586,2806,5336,56,75,1287.03,4.2
"2011","Ribble Valley 007","E02005276","Total",8261,4087,4174,8041,220,168,3069.54,2.7
"2011","Ribble Valley 008","E02005277","Total",8936,4371,4565,8745,191,214,3792.90,2.4
"2011","Rossendale 001","E02005278","Total",7711,3764,3947,7632,79,138,2468.43,3.1
"2011","Rossendale 002","E02005279","Total",10264,5041,5223,10140,124,112,1590.06,6.5
"2011","Rossendale 003","E02005280","Total",10107,4986,5121,10026,81,99,1446.19,7.0
"2011","Rossendale 004","E02005281","Total",8251,4086,4165,8178,73,122,668.35,12.3
"2011","Rossendale 007","E02005284","Total",5805,2819,2986,5679,126,90,1887.97,3.1
"2011","Rossendale 008","E02005285","Total",6263,3008,3255,6164,99,113,2398.11,2.6
"2011","Rossendale 009","E02005286","Total",7500,3708,3792,7466,34,84,1813.93,4.1
"2011","Rossendale 010","E02006884","Total",12081,5955,6126,11977,104,93,1531.78,7.9
"2011","South Ribble 001","E02005287","Total",5354,2617,2737,5298,56,105,480.80,11.1
"2011","South Ribble 002","E02005288","Total",6054,2960,3094,5979,75,75,2577.12,2.3
"2011","South Ribble 003","E02005289","Total",6176,2969,3207,6172,4,110,246.27,25.1
"2011","South Ribble 004","E02005290","Total",7210,3575,3635,7168,42,85,465.85,15.5
"2011","South Ribble 005","E02005291","Total",5700,2787,2913,5694,6,58,196.39,29.0
"2011","South Ribble 006","E02005292","Total",5817,2817,3000,5742,75,51,200.87,29.0
"2011","South Ribble 007","E02005293","Total",5593,2705,2888,5524,69,44,147.00,38.0
"2011","South Ribble 008","E02005294","Total",6331,3045,3286,6290,41,50,442.67,14.3
"2011","South Ribble 009","E02005295","Total",7432,3703,3729,7371,61,56,251.53,29.5
"2011","South Ribble 010","E02005296","Total",5790,2816,2974,5725,65,109,1059.81,5.5
"2011","South Ribble 011","E02005297","Total",8206,4042,4164,8154,52,146,2712.16,3.0
"2011","South Ribble 012","E02005298","Total",7177,3533,3644,7136,41,62,932.01,7.7
"2011","South Ribble 013","E02005299","Total",7211,3551,3660,7185,26,70,173.98,41.4
"2011","South Ribble 014","E02005300","Total",5228,2600,2628,5184,44,63,518.64,10.1
"2011","South Ribble 015","E02005301","Total",6438,3123,3315,6354,84,62,227.70,28.3
"2011","South Ribble 016","E02005302","Total",6971,3417,3554,6968,3,81,339.36,20.5
"2011","South Ribble 017","E02005303","Total",6369,3084,3285,6281,88,46,323.41,19.7
"2011","West Lancashire 001","E02005304","Total",8583,4264,4319,8559,24,97,2701.63,3.2
"2011","West Lancashire 002","E02005305","Total",7305,3619,3686,7245,60,97,5741.05,1.3
"2011","West Lancashire 003","E02005306","Total",7048,3499,3549,6960,88,83,9790.80,0.7
"2011","West Lancashire 004","E02005307","Total",9182,4508,4674,9073,109,101,1215.66,7.6
"2011","West Lancashire 005","E02005308","Total",6670,3185,3485,6561,109,116,3163.37,2.1
"2011","West Lancashire 006","E02005309","Total",8381,4049,4332,8283,98,108,584.14,14.3
"2011","West Lancashire 007","E02005310","Total",7961,3662,4299,7261,700,140,320.85,24.8
"2011","West Lancashire 008","E02005311","Total",5576,2725,2851,5294,282,112,6510.47,0.9
"2011","West Lancashire 009","E02005312","Total",5927,2911,3016,5927,0,82,389.71,15.2
"2011","West Lancashire 010","E02005313","Total",8794,4245,4549,8679,115,43,317.13,27.7
"2011","West Lancashire 011","E02005314","Total",6458,3160,3298,6393,65,49,373.43,17.3
"2011","West Lancashire 012","E02005315","Total",8068,3898,4170,7868,200,171,1657.40,4.9
"2011","West Lancashire 013","E02005316","Total",6266,3132,3134,6210,56,52,262.18,23.9
"2011","West Lancashire 014","E02005317","Total",7090,3423,3667,7078,12,33,152.93,46.4
"2011","West Lancashire 015","E02005318","Total",7376,3560,3816,7298,78,81,1498.21,4.9
"2011","Wyre 001","E02005319","Total",8340,4187,4153,8284,56,63,161.18,51.7
"2011","Wyre 002","E02005320","Total",5906,2832,3074,5787,119,51,145.79,40.5
"2011","Wyre 003","E02005321","Total",6381,3082,3299,5998,383,45,222.88,28.6
"2011","Wyre 004","E02005322","Total",9921,4820,5101,9723,198,103,3049.64,3.3
"2011","Wyre 005","E02005323","Total",6863,3289,3574,6813,50,57,581.96,11.8
"2011","Wyre 006","E02005324","Total",6117,3083,3034,5670,447,142,10552.34,0.6
"2011","Wyre 007","E02005325","Total",8968,4329,4639,8916,52,120,2517.57,3.6
"2011","Wyre 008","E02005326","Total",8559,4160,4399,8389,170,69,193.73,44.2
"2011","Wyre 009","E02005327","Total",5874,2897,2977,5822,52,88,8741.16,0.7
"2011","Wyre 010","E02005328","Total",7484,3584,3900,7454,30,106,222.55,33.6
"2011","Wyre 011","E02005329","Total",8757,4185,4572,8713,44,84,403.19,21.7
"2011","Wyre 012","E02005330","Total",8881,4284,4597,8860,21,136,563.65,15.8
"2011","Wyre 013","E02005331","Total",7627,3601,4026,7465,162,120,423.26,18.0
"2011","Wyre 014","E02005332","Total",8071,3892,4179,8068,3,141,476.53,16.9
"2011","Knowsley 001","E02001327","Total",7451,3327,4124,7445,6,11,302.96,24.6
"2011","Knowsley 002","E02001328","Total",10145,4883,5262,10145,0,46,214.59,47.3
"2011","Knowsley 003","E02001329","Total",7603,3680,3923,7553,50,23,283.25,26.8
"2011","Knowsley 004","E02001330","Total",8706,4078,4628,8633,73,29,273.59,31.8
"2011","Knowsley 005","E02001331","Total",10062,4721,5341,10060,2,54,2388.38,4.2
"2011","Knowsley 006","E02001332","Total",6644,3194,3450,6600,44,29,185.81,35.8
"2011","Knowsley 007","E02001333","Total",8200,3973,4227,8113,87,56,274.10,29.9
"2011","Knowsley 008","E02001334","Total",5780,2653,3127,5780,0,18,122.07,47.3
"2011","Knowsley 009","E02001335","Total",7668,3705,3963,7599,69,65,172.94,44.3
"2011","Knowsley 010","E02001336","Total",6833,3189,3644,6744,89,22,325.51,21.0
"2011","Knowsley 011","E02001337","Total",5933,2812,3121,5933,0,44,187.23,31.7
"2011","Knowsley 012","E02001338","Total",5935,2792,3143,5890,45,24,109.18,54.4
"2011","Knowsley 013","E02001339","Total",6739,3246,3493,6739,0,30,199.36,33.8
"2011","Knowsley 014","E02001340","Total",8997,4312,4685,8959,38,71,183.80,48.9
"2011","Knowsley 015","E02001341","Total",6857,3199,3658,6810,47,29,235.66,29.1
"2011","Knowsley 016","E02001342","Total",7172,3377,3795,6989,183,68,339.16,21.1
"2011","Knowsley 017","E02001343","Total",7118,3475,3643,7114,4,63,2137.15,3.3
"2011","Knowsley 018","E02001344","Total",5343,2543,2800,5183,160,32,255.01,21.0
"2011","Knowsley 019","E02001345","Total",5637,2767,2870,5637,0,33,130.57,43.2
"2011","Knowsley 020","E02001346","Total",7070,3403,3667,7064,6,34,326.61,21.6
"2011","Liverpool 001","E02001347","Total",7653,3655,3998,7628,25,28,226.67,33.8
"2011","Liverpool 002","E02001348","Total",7222,3526,3696,7222,0,27,105.76,68.3
"2011","Liverpool 003","E02001349","Total",7966,3982,3984,7943,23,42,124.00,64.2
"2011","Liverpool 004","E02001350","Total",7856,3661,4195,7714,142,22,289.22,27.2
"2011","Liverpool 005","E02001351","Total",8894,4580,4314,8141,753,38,304.32,29.2
"2011","Liverpool 006","E02001352","Total",7416,4206,3210,6620,796,10,106.15,69.9
"2011","Liverpool 007","E02001353","Total",7572,3645,3927,7526,46,60,236.14,32.1
"2011","Liverpool 008","E02001354","Total",7613,3642,3971,7611,2,18,166.69,45.7
"2011","Liverpool 009","E02001355","Total",6664,3239,3425,6660,4,22,134.41,49.6
"2011","Liverpool 010","E02001356","Total",5584,2549,3035,5584,0,29,127.42,43.8
"2011","Liverpool 011","E02001357","Total",6982,3157,3825,6955,27,24,110.12,63.4
"2011","Liverpool 012","E02001358","Total",7069,3423,3646,7041,28,26,59.71,118.4
"2011","Liverpool 013","E02001359","Total",5751,2768,2983,5740,11,55,290.16,19.8
"2011","Liverpool 014","E02001360","Total",8358,4222,4136,8289,69,39,240.25,34.8
"2011","Liverpool 015","E02001361","Total",7618,3611,4007,7618,0,31,151.43,50.3
"2011","Liverpool 016","E02001362","Total",7401,3498,3903,7401,0,36,135.49,54.6
"2011","Liverpool 017","E02001363","Total",7788,3578,4210,7788,0,25,155.80,50.0
"2011","Liverpool 018","E02001364","Total",5311,2561,2750,5203,108,17,103.18,51.5
"2011","Liverpool 019","E02001365","Total",9049,4480,4569,8950,99,32,87.67,103.2
"2011","Liverpool 020","E02001366","Total",8985,4535,4450,8912,73,34,152.33,59.0
"2011","Liverpool 021","E02001367","Total",9304,4444,4860,9296,8,96,247.09,37.7
"2011","Liverpool 022","E02001368","Total",5847,2836,3011,5771,76,12,342.40,17.1
"2011","Liverpool 023","E02001369","Total",7655,3943,3712,7637,18,22,204.65,37.4
"2011","Liverpool 024","E02001370","Total",6186,3068,3118,6155,31,14,111.08,55.7
"2011","Liverpool 025","E02001371","Total",7447,3408,4039,7347,100,23,92.93,80.1
"2011","Liverpool 026","E02001372","Total",6221,3018,3203,6014,207,41,176.28,35.3
"2011","Liverpool 027","E02001373","Total",9253,4528,4725,9210,43,60,163.44,56.6
"2011","Liverpool 028","E02001374","Total",8199,4499,3700,8051,148,54,232.45,35.3
"2011","Liverpool 029","E02001375","Total",7195,3352,3843,7100,95,42,92.59,77.7
"2011","Liverpool 030","E02001376","Total",8469,4285,4184,8445,24,37,87.42,96.9
"2011","Liverpool 031","E02001377","Total",11467,5792,5675,8525,2942,141,174.46,65.7
"2011","Liverpool 032","E02001378","Total",7972,3920,4052,7733,239,39,135.01,59.0
"2011","Liverpool 034","E02001380","Total",7526,3622,3904,7519,7,64,153.06,49.2
"2011","Liverpool 035","E02001381","Total",9286,4697,4589,9280,6,42,129.67,71.6
"2011","Liverpool 036","E02001382","Total",7098,3438,3660,7093,5,78,130.99,54.2
"2011","Liverpool 037","E02001383","Total",7501,4118,3383,7125,376,63,109.92,68.2
"2011","Liverpool 038","E02001384","Total",10762,5418,5344,10739,23,101,98.13,109.7
"2011","Liverpool 039","E02001385","Total",8157,4245,3912,8106,51,51,94.39,86.4
"2011","Liverpool 040","E02001386","Total",7545,3571,3974,7518,27,28,184.00,41.0
"2011","Liverpool 041","E02001387","Total",8025,3826,4199,7955,70,159,162.51,49.4
"2011","Liverpool 042","E02001388","Total",8860,4471,4389,8802,58,77,124.41,71.2
"2011","Liverpool 043","E02001389","Total",6232,3440,2792,5919,313,17,110.51,56.4
"2011","Liverpool 044","E02001390","Total",8756,4363,4393,8689,67,33,124.99,70.1
"2011","Liverpool 045","E02001391","Total",5970,2741,3229,5887,83,22,263.30,22.7
"2011","Liverpool 046","E02001392","Total",5717,2778,2939,5699,18,67,174.20,32.8
"2011","Liverpool 047","E02001393","Total",7753,3692,4061,7203,550,200,345.74,22.4
"2011","Liverpool 048","E02001394","Total",10143,5098,5045,8158,1985,108,224.80,45.1
"2011","Liverpool 049","E02001395","Total",6056,2905,3151,6056,0,87,128.44,47.2
"2011","Liverpool 050","E02001396","Total",8035,4006,4029,7973,62,26,149.16,53.9
"2011","Liverpool 051","E02001397","Total",7631,3708,3923,7606,25,71,137.92,55.3
"2011","Liverpool 052","E02001398","Total",7758,3808,3950,7286,472,71,228.62,33.9
"2011","Liverpool 053","E02001399","Total",7276,3524,3752,7188,88,94,144.55,50.3
"2011","Liverpool 054","E02001400","Total",6614,3182,3432,6525,89,58,315.43,21.0
"2011","Liverpool 055","E02001401","Total",7872,3772,4100,7813,59,77,308.80,25.5
"2011","Liverpool 056","E02001402","Total",8384,4140,4244,8241,143,135,253.42,33.1
"2011","Liverpool 057","E02001403","Total",6035,3050,2985,6010,25,32,176.86,34.1
"2011","Liverpool 058","E02001404","Total",7260,3452,3808,7229,31,14,889.62,8.2
"2011","Liverpool 059","E02001405","Total",9609,4446,5163,9574,35,31,213.40,45.0
"2011","Liverpool 060","E02006932","Total",9949,5172,4777,5312,4637,195,147.73,67.3
"2011","Liverpool 061","E02006933","Total",5436,3072,2364,5383,53,33,162.67,33.4
"2011","Liverpool 062","E02006934","Total",5202,3117,2085,4367,835,53,130.39,39.9
"2011","Sefton 001","E02001429","Total",6751,3152,3599,6751,0,53,549.97,12.3
"2011","Sefton 002","E02001430","Total",7142,3331,3811,7071,71,95,326.23,21.9
"2011","Sefton 003","E02001431","Total",7288,3296,3992,6879,409,90,209.31,34.8
"2011","Sefton 004","E02001432","Total",8398,4148,4250,7838,560,45,624.00,13.5
"2011","Sefton 005","E02001433","Total",7642,3699,3943,7642,0,79,172.27,44.4
"2011","Sefton 006","E02001434","Total",7210,3579,3631,7051,159,102,201.25,35.8
"2011","Sefton 007","E02001435","Total",8058,3971,4087,7884,174,87,145.67,55.3
"2011","Sefton 008","E02001436","Total",8704,4172,4532,8614,90,92,340.41,25.6
"2011","Sefton 009","E02001437","Total",9586,4463,5123,9105,481,186,859.71,11.2
"2011","Sefton 010","E02001438","Total",7500,3588,3912,7487,13,116,172.77,43.4
"2011","Sefton 011","E02001439","Total",6291,2971,3320,6258,33,71,222.43,28.3
"2011","Sefton 012","E02001440","Total",5811,2787,3024,5809,2,96,597.90,9.7
"2011","Sefton 013","E02001441","Total",6564,3157,3407,6438,126,167,1331.92,4.9
"2011","Sefton 014","E02001442","Total",5887,2757,3130,5819,68,115,231.68,25.4
"2011","Sefton 015","E02001443","Total",5664,2736,2928,5594,70,108,491.41,11.5
"2011","Sefton 016","E02001444","Total",5730,2730,3000,5697,33,78,1331.94,4.3
"2011","Sefton 017","E02001445","Total",7021,3367,3654,6992,29,86,678.53,10.3
"2011","Sefton 018","E02001446","Total",6837,3306,3531,6711,126,64,243.11,28.1
"2011","Sefton 019","E02001447","Total",5964,2815,3149,5862,102,57,348.08,17.1
"2011","Sefton 020","E02001448","Total",6930,3343,3587,6902,28,57,239.09,29.0
"2011","Sefton 021","E02001449","Total",9241,4458,4783,9207,34,135,1681.37,5.5
"2011","Sefton 022","E02001450","Total",8187,3860,4327,8064,123,198,431.39,19.0
"2011","Sefton 023","E02001451","Total",6205,2841,3364,6025,180,34,125.29,49.5
"2011","Sefton 024","E02001452","Total",6623,3083,3540,6476,147,50,165.43,40.0
"2011","Sefton 025","E02001453","Total",8676,4145,4531,8621,55,132,154.98,56.0
"2011","Sefton 026","E02001454","Total",7371,3717,3654,7028,343,49,1016.23,7.3
"2011","Sefton 027","E02001455","Total",7197,3469,3728,7197,0,43,324.35,22.2
"2011","Sefton 028","E02001456","Total",7521,3550,3971,7449,72,100,162.10,46.4
"2011","Sefton 029","E02001457","Total",6771,3200,3571,6768,3,43,251.66,26.9
"2011","Sefton 030","E02001458","Total",7668,3797,3871,7652,16,76,107.63,71.2
"2011","Sefton 031","E02001459","Total",7267,3413,3854,7267,0,42,145.94,49.8
"2011","Sefton 032","E02001460","Total",7528,3744,3784,7327,201,49,308.42,24.4
"2011","Sefton 033","E02001461","Total",6326,3074,3252,6326,0,28,156.50,40.4
"2011","Sefton 034","E02001462","Total",7529,3590,3939,7514,15,37,220.27,34.2
"2011","Sefton 035","E02001463","Total",6850,3250,3600,6807,43,48,154.36,44.4
"2011","Sefton 036","E02001464","Total",6867,3277,3590,6812,55,26,95.56,71.9
"2011","Sefton 037","E02001465","Total",6395,3273,3122,6225,170,18,353.44,18.1
"2011","Sefton 038","E02001466","Total",8590,4128,4462,8528,62,48,141.01,60.9
"2011","St. Helens 001","E02001406","Total",7779,3699,4080,7732,47,124,2672.26,2.9
"2011","St. Helens 002","E02001407","Total",6179,3082,3097,6106,73,76,734.99,8.4
"2011","St. Helens 003","E02001408","Total",5753,2889,2864,5741,12,53,925.96,6.2
"2011","St. Helens 004","E02001409","Total",9815,4837,4978,9799,16,66,555.07,17.7
"2011","St. Helens 005","E02001410","Total",5837,2861,2976,5796,41,32,689.81,8.5
"2011","St. Helens 006","E02001411","Total",5871,2878,2993,5851,20,46,237.53,24.7
"2011","St. Helens 007","E02001412","Total",8823,4333,4490,8757,66,101,699.30,12.6
"2011","St. Helens 008","E02001413","Total",9682,4708,4974,9659,23,68,178.87,54.1
"2011","St. Helens 009","E02001414","Total",5355,2608,2747,5320,35,90,542.09,9.9
"2011","St. Helens 010","E02001415","Total",6592,3246,3346,6571,21,33,224.63,29.3
"2011","St. Helens 011","E02001416","Total",5926,2888,3038,5864,62,31,197.46,30.0
"2011","St. Helens 012","E02001417","Total",7187,3646,3541,7026,161,42,169.49,42.4
"2011","St. Helens 013","E02001418","Total",5235,2560,2675,5235,0,35,219.90,23.8
"2011","St. Helens 014","E02001419","Total",6818,3381,3437,6642,176,22,334.94,20.4
"2011","St. Helens 015","E02001420","Total",10206,5040,5166,10105,101,111,734.31,13.9
"2011","St. Helens 016","E02001421","Total",10509,5188,5321,10489,20,87,251.30,41.8
"2011","St. Helens 017","E02001422","Total",6362,3133,3229,6358,4,15,243.57,26.1
"2011","St. Helens 018","E02001423","Total",6324,3091,3233,6249,75,92,440.53,14.4
"2011","St. Helens 019","E02001424","Total",13529,6621,6908,13412,117,111,781.90,17.3
"2011","St. Helens 020","E02001425","Total",10460,5131,5329,10388,72,73,300.94,34.8
"2011","St. Helens 021","E02001426","Total",5400,2664,2736,5315,85,49,139.92,38.6
"2011","St. Helens 022","E02001427","Total",10213,5013,5200,10213,0,64,1840.91,5.5
"2011","St. Helens 023","E02001428","Total",5453,2641,2812,5330,123,78,522.57,10.4
"2011","Wirral 001","E02001467","Total",7547,3704,3843,7473,74,61,136.70,55.2
"2011","Wirral 002","E02001468","Total",7841,3796,4045,7610,231,72,101.02,77.6
"2011","Wirral 003","E02001469","Total",7829,3784,4045,7810,19,91,228.43,34.3
"2011","Wirral 004","E02001470","Total",8593,4112,4481,8564,29,155,146.54,58.6
"2011","Wirral 005","E02001471","Total",7525,3726,3799,7397,128,39,94.21,79.9
"2011","Wirral 006","E02001472","Total",7064,3421,3643,7064,0,61,421.77,16.7
"2011","Wirral 007","E02001473","Total",7660,3733,3927,7571,89,61,120.36,63.6
"2011","Wirral 008","E02001474","Total",7100,3479,3621,7049,51,27,119.93,59.2
"2011","Wirral 009","E02001475","Total",6168,2910,3258,6165,3,31,260.83,23.6
"2011","Wirral 010","E02001476","Total",7626,3674,3952,7624,2,41,261.70,29.1
"2011","Wirral 011","E02001477","Total",7510,3446,4064,7468,42,37,357.10,21.0
"2011","Wirral 012","E02001478","Total",7909,3844,4065,7860,49,52,191.12,41.4
"2011","Wirral 013","E02001479","Total",6173,2960,3213,6132,41,98,714.07,8.6
"2011","Wirral 014","E02001480","Total",7738,3689,4049,7471,267,158,331.30,23.4
"2011","Wirral 015","E02001481","Total",8109,3916,4193,7909,200,95,274.70,29.5
"2011","Wirral 016","E02001482","Total",7723,3938,3785,7632,91,28,286.54,27.0
"2011","Wirral 017","E02001483","Total",7396,3522,3874,7382,14,80,188.96,39.1
"2011","Wirral 018","E02001484","Total",7663,3586,4077,7560,103,123,268.19,28.6
"2011","Wirral 019","E02001485","Total",6382,2918,3464,6333,49,37,162.20,39.3
"2011","Wirral 020","E02001486","Total",8248,4052,4196,7800,448,102,260.82,31.6
"2011","Wirral 021","E02001487","Total",9284,4471,4813,9264,20,50,182.64,50.8
"2011","Wirral 022","E02001488","Total",8480,4123,4357,8398,82,70,122.76,69.1
"2011","Wirral 023","E02001489","Total",8293,3971,4322,8238,55,154,530.53,15.6
"2011","Wirral 024","E02001490","Total",8743,4296,4447,8743,0,82,249.30,35.1
"2011","Wirral 025","E02001491","Total",6833,3216,3617,6747,86,42,200.71,34.0
"2011","Wirral 026","E02001492","Total",7846,3684,4162,7710,136,127,431.91,18.2
"2011","Wirral 027","E02001493","Total",7970,3806,4164,7855,115,41,183.28,43.5
"2011","Wirral 028","E02001494","Total",7113,3433,3680,7076,37,218,632.35,11.2
"2011","Wirral 029","E02001495","Total",7789,3732,4057,7680,109,65,151.94,51.3
"2011","Wirral 030","E02001496","Total",6026,2910,3116,5971,55,85,198.49,30.4
"2011","Wirral 031","E02001497","Total",7971,3866,4105,7947,24,44,167.88,47.5
"2011","Wirral 032","E02001498","Total",7568,3650,3918,7555,13,110,187.15,40.4
"2011","Wirral 033","E02001499","Total",6691,3202,3489,6691,0,135,827.16,8.1
"2011","Wirral 034","E02001500","Total",7485,3606,3879,7436,49,136,839.16,8.9
"2011","Wirral 035","E02001501","Total",7971,3811,4160,7911,60,120,746.72,10.7
"2011","Wirral 036","E02001502","Total",8342,3952,4390,8098,244,58,526.55,15.8
"2011","Wirral 037","E02001503","Total",7518,3476,4042,7449,69,123,303.98,24.7
"2011","Wirral 038","E02001504","Total",7329,3523,3806,7122,207,113,2191.45,3.3
"2011","Wirral 039","E02001505","Total",6428,3093,3335,6365,63,72,276.75,23.2
"2011","Wirral 040","E02001506","Total",8980,4338,4642,8943,37,260,1010.43,8.9
"2011","Wirral 041","E02001507","Total",7296,3624,3672,7288,8,91,221.23,33.0
"2011","Wirral 042","E02001508","Total",8023,3854,4169,8023,0,57,596.08,13.5
"2011","East Riding of Yorkshire 001","E02002684","Total",9688,4649,5039,9630,58,92,5349.99,1.8
"2011","East Riding of Yorkshire 002","E02002685","Total",8071,3844,4227,8030,41,87,1639.64,4.9
"2011","East Riding of Yorkshire 003","E02002686","Total",7904,3737,4167,7758,146,35,615.23,12.8
"2011","East Riding of Yorkshire 004","E02002687","Total",6032,2952,3080,5724,308,33,123.42,48.9
"2011","East Riding of Yorkshire 005","E02002688","Total",5662,2830,2832,5343,319,54,97.86,57.9
"2011","East Riding of Yorkshire 006","E02002689","Total",5891,2857,3034,5789,102,82,19074.22,0.3
"2011","East Riding of Yorkshire 008","E02002691","Total",8074,3920,4154,8024,50,139,23334.45,0.3
"2011","East Riding of Yorkshire 009","E02002692","Total",8805,4586,4219,8133,672,153,7405.78,1.2
"2011","East Riding of Yorkshire 010","E02002693","Total",6842,3397,3445,6818,24,98,14772.75,0.5
"2011","East Riding of Yorkshire 011","E02002694","Total",10943,5309,5634,10751,192,190,14286.56,0.8
"2011","East Riding of Yorkshire 012","E02002695","Total",8099,3896,4203,7889,210,103,1749.68,4.6
"2011","East Riding of Yorkshire 013","E02002696","Total",6008,3027,2981,5882,126,148,12038.54,0.5
"2011","East Riding of Yorkshire 014","E02002697","Total",7593,3742,3851,7575,18,93,12356.20,0.6
"2011","East Riding of Yorkshire 015","E02002698","Total",7586,3701,3885,7528,58,89,6871.11,1.1
"2011","East Riding of Yorkshire 016","E02002699","Total",9442,4498,4944,9323,119,227,686.61,13.8
"2011","East Riding of Yorkshire 017","E02002700","Total",6308,3051,3257,6239,69,37,219.77,28.7
"2011","East Riding of Yorkshire 018","E02002701","Total",8541,4230,4311,8491,50,161,22675.04,0.4
"2011","East Riding of Yorkshire 019","E02002702","Total",9796,4679,5117,9696,100,148,624.41,15.7
"2011","East Riding of Yorkshire 020","E02002703","Total",9198,4444,4754,8841,357,180,3855.04,2.4
"2011","East Riding of Yorkshire 021","E02002704","Total",7241,3582,3659,7212,29,85,9677.21,0.7
"2011","East Riding of Yorkshire 022","E02002705","Total",6330,3051,3279,6253,77,113,2341.30,2.7
"2011","East Riding of Yorkshire 023","E02002706","Total",6907,3348,3559,6785,122,83,823.30,8.4
"2011","East Riding of Yorkshire 024","E02002707","Total",7617,4063,3554,6839,778,163,9158.88,0.8
"2011","East Riding of Yorkshire 025","E02002708","Total",7120,3417,3703,5845,1275,120,436.50,16.3
"2011","East Riding of Yorkshire 026","E02002709","Total",7534,3711,3823,7498,36,86,8107.92,0.9
"2011","East Riding of Yorkshire 027","E02002710","Total",7550,3614,3936,7489,61,90,227.02,33.3
"2011","East Riding of Yorkshire 028","E02002711","Total",7584,3727,3857,7443,141,131,793.31,9.6
"2011","East Riding of Yorkshire 029","E02002712","Total",7511,3607,3904,7348,163,79,2104.21,3.6
"2011","East Riding of Yorkshire 031","E02002714","Total",7707,3879,3828,7617,90,73,14529.97,0.5
"2011","East Riding of Yorkshire 032","E02002715","Total",12472,6101,6371,12403,69,198,2576.97,4.8
"2011","East Riding of Yorkshire 033","E02002716","Total",8570,4227,4343,8534,36,99,3787.43,2.3
"2011","East Riding of Yorkshire 034","E02002717","Total",7606,3646,3960,7574,32,68,248.53,30.6
"2011","East Riding of Yorkshire 035","E02002718","Total",7844,3851,3993,7772,72,181,1578.10,5.0
"2011","East Riding of Yorkshire 036","E02002719","Total",5925,2834,3091,5622,303,109,344.11,17.2
"2011","East Riding of Yorkshire 037","E02002720","Total",6994,3452,3542,6876,118,63,1907.81,3.7
"2011","East Riding of Yorkshire 038","E02002721","Total",6379,3142,3237,6310,69,57,9452.77,0.7
"2011","East Riding of Yorkshire 039","E02002722","Total",8744,4355,4389,8513,231,55,7895.99,1.1
"2011","East Riding of Yorkshire 040","E02002723","Total",8439,4106,4333,8260,179,62,5009.47,1.7
"2011","East Riding of Yorkshire 041","E02002724","Total",8789,4360,4429,8770,19,57,260.50,33.7
"2011","East Riding of Yorkshire 042","E02002725","Total",6599,3240,3359,6513,86,87,4627.16,1.4
"2011","East Riding of Yorkshire 043","E02006814","Total",8283,4000,4283,8281,2,79,234.35,35.3
"2011","East Riding of Yorkshire 044","E02006891","Total",7477,3629,3848,7388,89,120,6681.77,1.1
"2011","East Riding of Yorkshire 045","E02006892","Total",6474,3097,3377,6342,132,62,186.77,34.7
"2011","Kingston upon Hull 001","E02002652","Total",10846,5277,5569,10774,72,69,414.76,26.2
"2011","Kingston upon Hull 002","E02002653","Total",8323,4073,4250,8293,30,13,190.90,43.6
"2011","Kingston upon Hull 003","E02002654","Total",7640,3698,3942,7640,0,32,126.58,60.4
"2011","Kingston upon Hull 004","E02002655","Total",8926,4253,4673,8756,170,35,410.96,21.7
"2011","Kingston upon Hull 005","E02002656","Total",5361,2638,2723,5329,32,33,109.55,48.9
"2011","Kingston upon Hull 006","E02002657","Total",7537,3764,3773,7535,2,30,202.78,37.2
"2011","Kingston upon Hull 007","E02002658","Total",6881,3402,3479,6766,115,59,158.95,43.3
"2011","Kingston upon Hull 008","E02002659","Total",11018,5342,5676,11018,0,41,200.52,54.9
"2011","Kingston upon Hull 009","E02002660","Total",6942,3402,3540,6922,20,36,164.84,42.1
"2011","Kingston upon Hull 010","E02002661","Total",7963,3703,4260,7748,215,29,202.52,39.3
"2011","Kingston upon Hull 011","E02002662","Total",7215,3438,3777,7131,84,36,196.51,36.7
"2011","Kingston upon Hull 012","E02002663","Total",6850,3552,3298,6387,463,109,250.58,27.3
"2011","Kingston upon Hull 013","E02002664","Total",7614,3816,3798,7614,0,62,170.75,44.6
"2011","Kingston upon Hull 014","E02002665","Total",8312,4058,4254,8241,71,105,209.89,39.6
"2011","Kingston upon Hull 015","E02002666","Total",8961,4859,4102,8846,115,86,137.05,65.4
"2011","Kingston upon Hull 016","E02002667","Total",7110,3570,3540,7079,31,32,343.20,20.7
"2011","Kingston upon Hull 017","E02002668","Total",8864,4174,4690,8864,0,25,184.00,48.2
"2011","Kingston upon Hull 018","E02002669","Total",8486,4436,4050,8416,70,96,114.40,74.2
"2011","Kingston upon Hull 019","E02002670","Total",7871,3764,4107,7871,0,36,205.44,38.3
"2011","Kingston upon Hull 020","E02002671","Total",8365,4510,3855,7643,722,44,731.18,11.4
"2011","Kingston upon Hull 021","E02002672","Total",7373,3519,3854,7279,94,13,216.04,34.1
"2011","Kingston upon Hull 022","E02002673","Total",7916,3958,3958,7730,186,48,88.82,89.1
"2011","Kingston upon Hull 023","E02002674","Total",6905,3395,3510,6905,0,32,124.65,55.4
"2011","Kingston upon Hull 024","E02002675","Total",8464,4572,3892,8357,107,28,194.55,43.5
"2011","Kingston upon Hull 025","E02002676","Total",7581,3844,3737,7503,78,69,126.65,59.9
"2011","Kingston upon Hull 026","E02002677","Total",8420,4426,3994,8336,84,22,255.87,32.9
"2011","Kingston upon Hull 027","E02002678","Total",7692,3910,3782,7604,88,36,112.54,68.3
"2011","Kingston upon Hull 028","E02002679","Total",7415,3633,3782,7346,69,66,150.42,49.3
"2011","Kingston upon Hull 029","E02002680","Total",8871,5236,3635,8461,410,66,330.05,26.9
"2011","Kingston upon Hull 030","E02002681","Total",8511,4360,4151,8318,193,36,314.18,27.1
"2011","Kingston upon Hull 031","E02002682","Total",7953,3899,4054,7948,5,33,218.99,36.3
"2011","Kingston upon Hull 033","E02006813","Total",8220,3939,4281,8088,132,31,286.80,28.7
"2011","North East Lincolnshire 001","E02002726","Total",10273,5030,5243,10185,88,69,2329.93,4.4
"2011","North East Lincolnshire 002","E02002727","Total",5894,3104,2790,5857,37,16,213.97,27.5
"2011","North East Lincolnshire 003","E02002728","Total",7754,3842,3912,7754,0,44,364.52,21.3
"2011","North East Lincolnshire 004","E02002729","Total",5946,2950,2996,5911,35,62,387.61,15.3
"2011","North East Lincolnshire 005","E02002730","Total",7599,3807,3792,7598,1,36,92.84,81.9
"2011","North East Lincolnshire 006","E02002731","Total",5941,2915,3026,5941,0,26,54.91,108.2
"2011","North East Lincolnshire 007","E02002732","Total",7588,3752,3836,7518,70,119,4684.48,1.6
"2011","North East Lincolnshire 008","E02002733","Total",6052,2965,3087,5934,118,62,99.28,61.0
"2011","North East Lincolnshire 009","E02002734","Total",5146,2421,2725,5038,108,43,170.65,30.2
"2011","North East Lincolnshire 010","E02002735","Total",5354,2636,2718,5185,169,39,96.45,55.5
"2011","North East Lincolnshire 011","E02002736","Total",5872,3051,2821,5866,6,30,77.92,75.4
"2011","North East Lincolnshire 012","E02002737","Total",7426,3644,3782,7294,132,39,313.37,23.7
"2011","North East Lincolnshire 013","E02002738","Total",7161,3493,3668,7161,0,43,189.12,37.9
"2011","North East Lincolnshire 014","E02002739","Total",5974,2832,3142,5952,22,30,90.32,66.1
"2011","North East Lincolnshire 015","E02002740","Total",5604,2695,2909,5559,45,39,140.67,39.8
"2011","North East Lincolnshire 016","E02002741","Total",9200,4573,4627,8810,390,128,341.57,26.9
"2011","North East Lincolnshire 017","E02002742","Total",5693,2818,2875,5597,96,53,173.23,32.9
"2011","North East Lincolnshire 018","E02002743","Total",5460,2572,2888,5460,0,34,173.43,31.5
"2011","North East Lincolnshire 019","E02002744","Total",7124,3394,3730,7082,42,34,145.66,48.9
"2011","North East Lincolnshire 020","E02002745","Total",7621,3676,3945,7528,93,92,866.84,8.8
"2011","North East Lincolnshire 021","E02002746","Total",8832,4271,4561,8742,90,88,280.61,31.5
"2011","North East Lincolnshire 022","E02002747","Total",7999,3914,4085,7945,54,116,901.19,8.9
"2011","North East Lincolnshire 023","E02002748","Total",8103,3892,4211,7869,234,145,6995.92,1.2
"2011","North Lincolnshire 001","E02002749","Total",11066,5380,5686,10963,103,109,2562.90,4.3
"2011","North Lincolnshire 002","E02002750","Total",6282,3136,3146,6206,76,75,4365.04,1.4
"2011","North Lincolnshire 003","E02002751","Total",6451,3213,3238,6430,21,67,4207.44,1.5
"2011","North Lincolnshire 004","E02002752","Total",6801,3326,3475,6786,15,73,11500.30,0.6
"2011","North Lincolnshire 005","E02002753","Total",8691,4302,4389,8602,89,89,5675.37,1.5
"2011","North Lincolnshire 006","E02002754","Total",8288,4187,4101,8240,48,98,9323.53,0.9
"2011","North Lincolnshire 007","E02002755","Total",7038,3616,3422,6901,137,64,980.70,7.2
"2011","North Lincolnshire 008","E02002756","Total",8522,4349,4173,8436,86,56,157.55,54.1
"2011","North Lincolnshire 009","E02002757","Total",6188,3105,3083,6188,0,62,187.25,33.0
"2011","North Lincolnshire 010","E02002758","Total",6349,3126,3223,6347,2,49,975.60,6.5
"2011","North Lincolnshire 011","E02002759","Total",9610,4720,4890,9437,173,138,7972.36,1.2
"2011","North Lincolnshire 012","E02002760","Total",5876,2901,2975,5773,103,76,303.90,19.3
"2011","North Lincolnshire 013","E02002761","Total",6793,3310,3483,6610,183,59,6807.71,1.0
"2011","North Lincolnshire 014","E02002762","Total",6707,3242,3465,6626,81,37,141.38,47.4
"2011","North Lincolnshire 015","E02002763","Total",7379,3658,3721,7281,98,31,227.98,32.4
"2011","North Lincolnshire 016","E02002764","Total",5820,2815,3005,5820,0,26,174.70,33.3
"2011","North Lincolnshire 017","E02002765","Total",6373,3080,3293,6307,66,50,135.33,47.1
"2011","North Lincolnshire 018","E02002766","Total",9160,4468,4692,9105,55,103,209.63,43.7
"2011","North Lincolnshire 019","E02002767","Total",6788,3324,3464,6788,0,76,598.60,11.3
"2011","North Lincolnshire 020","E02002768","Total",7247,3543,3704,7243,4,99,6053.43,1.2
"2011","North Lincolnshire 021","E02002769","Total",5841,2856,2985,5835,6,114,6161.01,0.9
"2011","North Lincolnshire 022","E02002770","Total",7014,3480,3534,6853,161,114,7993.03,0.9
"2011","North Lincolnshire 023","E02002771","Total",7162,3486,3676,7094,68,112,7916.55,0.9
"2011","York 001","E02002772","Total",6923,3350,3573,6772,151,165,2060.91,3.4
"2011","York 002","E02002773","Total",5756,2681,3075,5699,57,84,792.92,7.3
"2011","York 003","E02002774","Total",6282,2943,3339,6184,98,123,861.67,7.3
"2011","York 004","E02002775","Total",5653,2597,3056,5543,110,68,434.50,13.0
"2011","York 005","E02002776","Total",6455,3092,3363,6455,0,70,622.68,10.4
"2011","York 006","E02002777","Total",8274,4075,4199,8272,2,119,1361.24,6.1
"2011","York 007","E02002778","Total",8280,4032,4248,7952,328,139,411.49,20.1
"2011","York 008","E02002779","Total",9588,4711,4877,9440,148,139,1822.93,5.3
"2011","York 009","E02002780","Total",8387,4032,4355,8236,151,67,110.36,76.0
"2011","York 010","E02002781","Total",9885,4764,5121,9485,400,103,170.13,58.1
"2011","York 011","E02002782","Total",6345,2990,3355,6013,332,155,4029.40,1.6
"2011","York 012","E02002783","Total",10164,5029,5135,10063,101,98,267.00,38.1
"2011","York 013","E02002784","Total",10622,5435,5187,9834,788,106,253.01,42.0
"2011","York 014","E02002785","Total",6872,3358,3514,6783,89,86,656.30,10.5
"2011","York 015","E02002786","Total",10668,5368,5300,10650,18,76,145.90,73.1
"2011","York 016","E02002787","Total",9075,4326,4749,8998,77,97,173.25,52.4
"2011","York 017","E02002788","Total",8921,4460,4461,8754,167,119,215.00,41.5
"2011","York 018","E02002789","Total",8862,4246,4616,8766,96,50,174.95,50.7
"2011","York 019","E02002790","Total",11399,5751,5648,10798,601,123,269.34,42.3
"2011","York 020","E02002791","Total",6540,3139,3401,6428,112,124,4641.37,1.4
"2011","York 021","E02002792","Total",7039,3393,3646,6990,49,88,373.53,18.8
"2011","York 022","E02002793","Total",9165,4437,4728,9164,1,112,341.02,26.9
"2011","York 023","E02002794","Total",8817,4125,4692,5045,3772,136,5085.77,1.7
"2011","York 024","E02002795","Total",8079,3920,4159,8068,11,191,1918.96,4.2
"2011","Craven 001","E02005742","Total",7414,3628,3786,7336,78,150,24092.50,0.3
"2011","Craven 002","E02005743","Total",5126,2492,2634,4956,170,127,41442.91,0.1
"2011","Craven 003","E02005744","Total",7678,3762,3916,7418,260,159,21087.13,0.4
"2011","Craven 004","E02005745","Total",5119,2486,2633,5032,87,168,18036.56,0.3
"2011","Craven 005","E02005746","Total",6406,3057,3349,6402,4,90,565.48,11.3
"2011","Craven 006","E02005747","Total",6650,3197,3453,6601,49,67,693.62,9.6
"2011","Craven 007","E02005748","Total",7375,3578,3797,7288,87,133,8961.11,0.8
"2011","Craven 008","E02005749","Total",9641,4554,5087,9342,299,161,2859.50,3.4
"2011","Hambleton 001","E02005750","Total",7838,3768,4070,7837,1,133,8629.15,0.9
"2011","Hambleton 002","E02005751","Total",8582,4201,4381,8581,1,223,17336.11,0.5
"2011","Hambleton 003","E02005752","Total",6663,3350,3313,6660,3,156,21621.33,0.3
"2011","Hambleton 004","E02005753","Total",13083,6373,6710,12744,339,150,1674.21,7.8
"2011","Hambleton 005","E02005754","Total",7476,3627,3849,7393,83,152,10192.54,0.7
"2011","Hambleton 006","E02005755","Total",6329,3089,3240,6248,81,115,7389.01,0.9
"2011","Hambleton 007","E02005756","Total",7217,3847,3370,6580,637,140,14871.66,0.5
"2011","Hambleton 008","E02005757","Total",8452,4117,4335,8379,73,137,9537.36,0.9
"2011","Hambleton 009","E02005758","Total",8330,4225,4105,8030,300,149,13481.17,0.6
"2011","Hambleton 010","E02005759","Total",8486,3992,4494,8464,22,197,14101.45,0.6
"2011","Hambleton 011","E02005760","Total",6684,3393,3291,6405,279,154,12282.96,0.5
"2011","Harrogate 001","E02005761","Total",5459,2658,2801,5408,51,132,24479.30,0.2
"2011","Harrogate 002","E02005762","Total",6287,3258,3029,5671,616,102,545.97,11.5
"2011","Harrogate 003","E02005763","Total",6518,3263,3255,6175,343,122,13485.36,0.5
"2011","Harrogate 004","E02005764","Total",10415,5123,5292,10277,138,91,447.86,23.3
"2011","Harrogate 005","E02005765","Total",6211,3039,3172,6110,101,133,6810.95,0.9
"2011","Harrogate 006","E02005766","Total",6118,3005,3113,6089,29,112,27721.05,0.2
"2011","Harrogate 007","E02005767","Total",6732,3282,3450,6675,57,189,5396.78,1.2
"2011","Harrogate 008","E02005768","Total",6028,2965,3063,5921,107,130,2826.01,2.1
"2011","Harrogate 009","E02005769","Total",6902,3351,3551,6892,10,88,261.68,26.4
"2011","Harrogate 010","E02005770","Total",9326,4521,4805,9320,6,100,457.99,20.4
"2011","Harrogate 011","E02005771","Total",7363,3597,3766,7363,0,69,230.00,32.0
"2011","Harrogate 012","E02005772","Total",6150,2991,3159,6056,94,147,2797.68,2.2
"2011","Harrogate 013","E02005773","Total",8831,4281,4550,8668,163,83,260.07,34.0
"2011","Harrogate 014","E02005774","Total",9370,4496,4874,9164,206,91,222.50,42.1
"2011","Harrogate 015","E02005775","Total",9287,4606,4681,8764,523,140,213.56,43.5
"2011","Harrogate 016","E02005776","Total",8407,4174,4233,7733,674,210,16939.55,0.5
"2011","Harrogate 017","E02005777","Total",8465,4052,4413,8265,200,185,555.01,15.3
"2011","Harrogate 018","E02005778","Total",6169,3060,3109,6056,113,136,20317.02,0.3
"2011","Harrogate 019","E02005779","Total",7581,3601,3980,7375,206,163,208.20,36.4
"2011","Harrogate 020","E02005780","Total",10603,4980,5623,10279,324,276,692.07,15.3
"2011","Harrogate 021","E02005781","Total",5647,2734,2913,5560,87,199,5925.07,1.0
"2011","Richmondshire 001","E02005782","Total",7578,3756,3822,7492,86,200,23424.18,0.3
"2011","Richmondshire 002","E02005783","Total",8413,4039,4374,8316,97,182,1019.45,8.3
"2011","Richmondshire 003","E02005784","Total",6229,3322,2907,5526,703,106,4329.92,1.4
"2011","Richmondshire 004","E02005785","Total",15280,9122,6158,11730,3550,188,2396.88,6.4
"2011","Richmondshire 005","E02005786","Total",6115,3033,3082,6097,18,112,74884.85,0.1
"2011","Richmondshire 006","E02005787","Total",8350,4135,4215,8183,167,138,25811.84,0.3
"2011","Ryedale 001","E02005788","Total",6399,3162,3237,6369,30,108,29466.51,0.2
"2011","Ryedale 002","E02005789","Total",10086,4744,5342,9956,130,170,21131.52,0.5
"2011","Ryedale 003","E02005790","Total",6904,3532,3372,6198,706,177,35061.38,0.2
"2011","Ryedale 004","E02005791","Total",6689,3355,3334,6678,11,100,33567.62,0.2
"2011","Ryedale 007","E02005794","Total",9398,4615,4783,9357,41,235,28660.05,0.3
"2011","Ryedale 008","E02006870","Total",12275,6005,6270,12053,222,138,2772.33,4.4
"2011","Scarborough 001","E02005795","Total",7044,3354,3690,6756,288,65,263.01,26.8
"2011","Scarborough 002","E02005796","Total",6891,3418,3473,6853,38,130,31522.54,0.2
"2011","Scarborough 003","E02005797","Total",6169,3065,3104,6119,50,85,685.94,9.0
"2011","Scarborough 004","E02005798","Total",8525,4092,4433,8281,244,141,26232.15,0.3
"2011","Scarborough 005","E02005799","Total",8991,4249,4742,8931,60,144,666.82,13.5
"2011","Scarborough 006","E02005800","Total",8057,4100,3957,7773,284,55,196.51,41.0
"2011","Scarborough 007","E02005801","Total",5625,2716,2909,5515,110,51,137.76,40.8
"2011","Scarborough 008","E02005802","Total",8357,3971,4386,8290,67,90,83.57,100.0
"2011","Scarborough 009","E02005803","Total",9084,4317,4767,8851,233,129,566.51,16.0
"2011","Scarborough 010","E02005804","Total",8200,4057,4143,7485,715,86,294.02,27.9
"2011","Scarborough 011","E02005805","Total",7084,3369,3715,6873,211,69,2357.20,3.0
"2011","Scarborough 012","E02005806","Total",7166,3466,3700,7133,33,56,784.48,9.1
"2011","Scarborough 013","E02005807","Total",6206,2955,3251,6178,28,124,10055.25,0.6
"2011","Scarborough 014","E02005808","Total",11394,5441,5953,11389,5,115,7808.37,1.5
"2011","Selby 001","E02005809","Total",7261,3564,3697,7252,9,133,2773.77,2.6
"2011","Selby 002","E02005810","Total",8842,4353,4489,8811,31,144,14869.78,0.6
"2011","Selby 003","E02005811","Total",9109,4351,4758,8818,291,154,9124.17,1.0
"2011","Selby 004","E02005812","Total",9025,4438,4587,8992,33,117,3853.29,2.3
"2011","Selby 005","E02005813","Total",10886,5371,5515,10797,89,68,752.85,14.5
"2011","Selby 006","E02005814","Total",6418,3054,3364,6291,127,85,1318.26,4.9
"2011","Selby 007","E02005815","Total",8214,4095,4119,8211,3,111,3369.35,2.4
"2011","Selby 008","E02005816","Total",8415,4159,4256,8341,74,107,7647.82,1.1
"2011","Selby 009","E02005817","Total",7125,3497,3628,7100,25,92,4994.98,1.4
"2011","Selby 010","E02005818","Total",8154,4065,4089,8112,42,92,11226.92,0.7
"2011","Barnsley 001","E02001509","Total",6279,3063,3216,6210,69,59,446.73,14.1
"2011","Barnsley 002","E02001510","Total",5878,2903,2975,5878,0,40,472.59,12.4
"2011","Barnsley 003","E02001511","Total",6191,3056,3135,6162,29,45,631.55,9.8
"2011","Barnsley 004","E02001512","Total",7642,3706,3936,7521,121,59,530.68,14.4
"2011","Barnsley 005","E02001513","Total",7803,3792,4011,7766,37,83,979.50,8.0
"2011","Barnsley 006","E02001514","Total",7267,3557,3710,7141,126,40,1043.32,7.0
"2011","Barnsley 007","E02001515","Total",9257,4546,4711,9231,26,35,293.21,31.6
"2011","Barnsley 008","E02001516","Total",6098,3006,3092,6045,53,41,461.82,13.2
"2011","Barnsley 009","E02001517","Total",7886,3922,3964,7834,52,45,370.03,21.3
"2011","Barnsley 010","E02001518","Total",10013,4938,5075,9952,61,80,388.50,25.8
"2011","Barnsley 011","E02001519","Total",6749,3258,3491,6617,132,35,461.58,14.6
"2011","Barnsley 012","E02001520","Total",10662,5228,5434,10601,61,107,904.15,11.8
"2011","Barnsley 013","E02001521","Total",11267,5722,5545,11197,70,75,342.02,32.9
"2011","Barnsley 014","E02001522","Total",8687,4245,4442,8611,76,33,503.47,17.3
"2011","Barnsley 015","E02001523","Total",6755,3375,3380,6677,78,36,535.06,12.6
"2011","Barnsley 016","E02001524","Total",5902,2886,3016,5902,0,103,3561.14,1.7
"2011","Barnsley 017","E02001525","Total",6010,2957,3053,5933,77,37,138.31,43.5
"2011","Barnsley 018","E02001526","Total",5827,2903,2924,5790,37,30,165.54,35.2
"2011","Barnsley 019","E02001527","Total",5900,2898,3002,5836,64,56,575.49,10.3
"2011","Barnsley 020","E02001528","Total",10286,4994,5292,10177,109,78,2071.59,5.0
"2011","Barnsley 021","E02001529","Total",9416,4601,4815,9358,58,54,864.99,10.9
"2011","Barnsley 022","E02001530","Total",6240,3093,3147,6236,4,40,558.68,11.2
"2011","Barnsley 023","E02001531","Total",6424,3228,3196,6398,26,20,391.63,16.4
"2011","Barnsley 024","E02001532","Total",9492,4692,4800,9487,5,121,1006.10,9.4
"2011","Barnsley 025","E02001533","Total",7460,3621,3839,7402,58,28,496.34,15.0
"2011","Barnsley 026","E02001534","Total",9135,4426,4709,9016,119,59,649.46,14.1
"2011","Barnsley 027","E02001535","Total",6114,3071,3043,6093,21,93,11379.85,0.5
"2011","Barnsley 028","E02001536","Total",8396,4029,4367,8349,47,56,1567.14,5.4
"2011","Barnsley 029","E02001537","Total",8240,4031,4209,8214,26,48,740.28,11.1
"2011","Barnsley 030","E02001538","Total",7945,3887,4058,7905,40,45,374.56,21.2
"2011","Doncaster 001","E02001539","Total",6018,2926,3092,6018,0,41,4052.09,1.5
"2011","Doncaster 002","E02001540","Total",11673,5756,5917,11559,114,79,6839.62,1.7
"2011","Doncaster 003","E02001541","Total",11277,5472,5805,11125,152,99,648.20,17.4
"2011","Doncaster 004","E02001542","Total",7479,3662,3817,7411,68,32,3515.81,2.1
"2011","Doncaster 005","E02001543","Total",8485,4126,4359,8394,91,40,637.55,13.3
"2011","Doncaster 006","E02001544","Total",8711,4208,4503,8628,83,62,670.84,13.0
"2011","Doncaster 007","E02001545","Total",8592,4222,4370,8586,6,76,1340.64,6.4
"2011","Doncaster 008","E02001546","Total",8615,5258,3357,6541,2074,85,5535.05,1.6
"2011","Doncaster 009","E02001547","Total",10737,5291,5446,10672,65,58,818.95,13.1
"2011","Doncaster 010","E02001548","Total",8009,3834,4175,7934,75,45,1209.57,6.6
"2011","Doncaster 011","E02001549","Total",5969,2923,3046,5951,18,67,416.44,14.3
"2011","Doncaster 012","E02001550","Total",7463,3594,3869,7441,22,67,269.43,27.7
"2011","Doncaster 013","E02001551","Total",6027,2986,3041,6006,21,55,522.53,11.5
"2011","Doncaster 014","E02001552","Total",7686,3731,3955,7593,93,40,647.49,11.9
"2011","Doncaster 015","E02001553","Total",10018,4841,5177,10018,0,78,534.61,18.7
"2011","Doncaster 016","E02001554","Total",6420,3139,3281,6401,19,90,368.88,17.4
"2011","Doncaster 017","E02001555","Total",5578,2704,2874,5515,63,53,437.32,12.8
"2011","Doncaster 018","E02001556","Total",9294,4441,4853,9239,55,79,276.24,33.6
"2011","Doncaster 019","E02001557","Total",9487,4876,4611,9217,270,113,381.29,24.9
"2011","Doncaster 020","E02001558","Total",6125,2948,3177,6087,38,77,7307.98,0.8
"2011","Doncaster 021","E02001559","Total",7742,3699,4043,7702,40,140,873.92,8.9
"2011","Doncaster 022","E02001560","Total",10508,5681,4827,9735,773,71,398.48,26.4
"2011","Doncaster 023","E02001561","Total",6318,3313,3005,6263,55,46,131.06,48.2
"2011","Doncaster 024","E02001562","Total",5905,2816,3089,5858,47,57,303.80,19.4
"2011","Doncaster 025","E02001563","Total",7635,3671,3964,7520,115,150,258.40,29.5
"2011","Doncaster 026","E02001564","Total",7548,3671,3877,7531,17,134,3486.75,2.2
"2011","Doncaster 027","E02001565","Total",6822,3385,3437,6769,53,134,557.38,12.2
"2011","Doncaster 028","E02001566","Total",7937,3974,3963,7893,44,76,599.38,13.2
"2011","Doncaster 029","E02001567","Total",9155,4481,4674,9099,56,82,216.64,42.3
"2011","Doncaster 030","E02001568","Total",5906,2921,2985,5906,0,31,388.42,15.2
"2011","Doncaster 031","E02001569","Total",9207,4503,4704,9055,152,49,197.44,46.6
"2011","Doncaster 032","E02001570","Total",7001,3392,3609,6898,103,30,570.67,12.3
"2011","Doncaster 033","E02001571","Total",6086,3004,3082,6052,34,67,3172.77,1.9
"2011","Doncaster 034","E02001572","Total",7236,3499,3737,7192,44,32,750.55,9.6
"2011","Doncaster 035","E02001573","Total",7859,3815,4044,7811,48,39,257.57,30.5
"2011","Doncaster 036","E02001574","Total",6268,3094,3174,6208,60,57,746.83,8.4
"2011","Doncaster 037","E02001575","Total",7269,3449,3820,7146,123,26,483.51,15.0
"2011","Doncaster 038","E02001576","Total",5816,2834,2982,5801,15,105,2356.00,2.5
"2011","Doncaster 039","E02001577","Total",6521,3090,3431,6425,96,102,4619.12,1.4
"2011","Rotherham 001","E02001578","Total",9461,4684,4777,9366,95,66,445.09,21.3
"2011","Rotherham 002","E02001579","Total",9205,4438,4767,9079,126,88,897.36,10.3
"2011","Rotherham 003","E02001580","Total",8261,4031,4230,8212,49,75,377.73,21.9
"2011","Rotherham 004","E02001581","Total",5854,2884,2970,5814,40,33,221.38,26.4
"2011","Rotherham 005","E02001582","Total",7216,3547,3669,7174,42,48,396.08,18.2
"2011","Rotherham 006","E02001583","Total",5665,2742,2923,5661,4,39,363.12,15.6
"2011","Rotherham 007","E02001584","Total",7105,3472,3633,7080,25,95,2770.07,2.6
"2011","Rotherham 008","E02001585","Total",6263,3044,3219,6131,132,27,351.33,17.8
"2011","Rotherham 009","E02001586","Total",8129,4115,4014,8048,81,41,571.17,14.2
"2011","Rotherham 010","E02001587","Total",5824,2812,3012,5774,50,27,1185.63,4.9
"2011","Rotherham 011","E02001588","Total",7151,3459,3692,7078,73,30,162.07,44.1
"2011","Rotherham 012","E02001589","Total",8173,4019,4154,8162,11,66,880.17,9.3
"2011","Rotherham 013","E02001590","Total",7492,3688,3804,7473,19,28,280.33,26.7
"2011","Rotherham 014","E02001591","Total",8299,4149,4150,8219,80,28,233.72,35.5
"2011","Rotherham 015","E02001592","Total",8899,4367,4532,8863,36,70,510.82,17.4
"2011","Rotherham 016","E02001593","Total",7095,3595,3500,7034,61,37,318.81,22.3
"2011","Rotherham 017","E02001594","Total",6880,3524,3356,6564,316,57,311.80,22.1
"2011","Rotherham 018","E02001595","Total",8765,4302,4463,8658,107,84,538.48,16.3
"2011","Rotherham 019","E02001596","Total",8651,4165,4486,8557,94,95,173.10,50.0
"2011","Rotherham 020","E02001597","Total",9528,4685,4843,9481,47,57,1764.99,5.4
"2011","Rotherham 021","E02001598","Total",9629,4552,5077,9575,54,104,427.87,22.5
"2011","Rotherham 022","E02001599","Total",6260,3030,3230,6250,10,102,489.92,12.8
"2011","Rotherham 023","E02001600","Total",10777,5308,5469,10729,48,180,382.17,28.2
"2011","Rotherham 024","E02001601","Total",5042,2500,2542,5027,15,52,1026.85,4.9
"2011","Rotherham 025","E02001602","Total",8960,4371,4589,8960,0,60,512.33,17.5
"2011","Rotherham 026","E02001603","Total",6583,3253,3330,6562,21,42,1338.38,4.9
"2011","Rotherham 027","E02001604","Total",8575,4210,4365,8455,120,52,1258.39,6.8
"2011","Rotherham 028","E02001605","Total",7234,3628,3606,7216,18,81,3368.99,2.1
"2011","Rotherham 029","E02001606","Total",8010,3909,4101,7896,114,71,528.35,15.2
"2011","Rotherham 030","E02001607","Total",8812,4315,4497,8788,24,68,581.07,15.2
"2011","Rotherham 031","E02001608","Total",6872,3372,3500,6872,0,55,1022.59,6.7
"2011","Rotherham 032","E02001609","Total",8368,4087,4281,8353,15,118,1849.07,4.5
"2011","Rotherham 033","E02001610","Total",8242,3990,4252,8223,19,102,3114.54,2.6
"2011","Sheffield 001","E02001611","Total",7597,3718,3879,7463,134,58,571.90,13.3
"2011","Sheffield 002","E02001612","Total",5858,2876,2982,5844,14,60,1331.39,4.4
"2011","Sheffield 003","E02001613","Total",10444,5032,5412,10425,19,69,427.42,24.4
"2011","Sheffield 004","E02001614","Total",11226,5511,5715,11083,143,93,532.14,21.1
"2011","Sheffield 005","E02001615","Total",7519,3638,3881,7457,62,77,1109.10,6.8
"2011","Sheffield 006","E02001616","Total",7091,3458,3633,7086,5,37,164.55,43.1
"2011","Sheffield 007","E02001617","Total",5615,2662,2953,5615,0,26,163.09,34.4
"2011","Sheffield 008","E02001618","Total",9675,4810,4865,9581,94,115,12470.36,0.8
"2011","Sheffield 009","E02001619","Total",9422,4588,4834,9391,31,49,231.91,40.6
"2011","Sheffield 010","E02001620","Total",6568,3116,3452,6563,5,35,140.66,46.7
"2011","Sheffield 011","E02001621","Total",5471,2667,2804,5435,36,27,148.58,36.8
"2011","Sheffield 012","E02001622","Total",8884,4295,4589,8805,79,26,211.45,42.0
"2011","Sheffield 013","E02001623","Total",8276,3897,4379,8163,113,40,153.44,53.9
"2011","Sheffield 014","E02001624","Total",9679,4739,4940,9620,59,44,358.40,27.0
"2011","Sheffield 015","E02001625","Total",7830,3773,4057,7712,118,21,150.36,52.1
"2011","Sheffield 016","E02001626","Total",5910,2783,3127,5910,0,51,90.86,65.0
"2011","Sheffield 017","E02001627","Total",6070,2992,3078,6068,2,34,324.56,18.7
"2011","Sheffield 018","E02001628","Total",6329,3197,3132,6277,52,34,716.21,8.8
"2011","Sheffield 019","E02001629","Total",6489,3302,3187,6402,87,39,172.08,37.7
"2011","Sheffield 020","E02001630","Total",8681,4394,4287,8547,134,54,197.86,43.9
"2011","Sheffield 021","E02001631","Total",7778,3811,3967,7746,32,53,136.25,57.1
"2011","Sheffield 022","E02001632","Total",12300,6358,5942,12188,112,49,553.95,22.2
"2011","Sheffield 023","E02001633","Total",7425,3582,3843,7393,32,94,1821.51,4.1
"2011","Sheffield 024","E02001634","Total",9214,4605,4609,9214,0,72,142.45,64.7
"2011","Sheffield 025","E02001635","Total",6032,2975,3057,6001,31,55,339.97,17.7
"2011","Sheffield 026","E02001636","Total",9597,4905,4692,8757,840,43,176.23,54.5
"2011","Sheffield 027","E02001637","Total",6925,3464,3461,6925,0,29,426.83,16.2
"2011","Sheffield 028","E02001638","Total",6362,3224,3138,6318,44,78,46.06,138.1
"2011","Sheffield 029","E02001639","Total",6157,2956,3201,6100,57,48,81.49,75.6
"2011","Sheffield 030","E02001640","Total",8302,4197,4105,8178,124,82,142.33,58.3
"2011","Sheffield 032","E02001642","Total",9663,4819,4844,9589,74,38,343.45,28.1
"2011","Sheffield 033","E02001643","Total",6292,3052,3240,6288,4,133,332.10,18.9
"2011","Sheffield 036","E02001646","Total",8525,4301,4224,7938,587,101,131.48,64.8
"2011","Sheffield 037","E02001647","Total",6111,2957,3154,6052,59,35,207.64,29.4
"2011","Sheffield 038","E02001648","Total",8833,4268,4565,6851,1982,186,212.00,41.7
"2011","Sheffield 039","E02001649","Total",9428,4631,4797,9424,4,36,313.65,30.1
"2011","Sheffield 040","E02001650","Total",9106,4776,4330,7687,1419,66,84.00,108.4
"2011","Sheffield 041","E02001651","Total",8153,3928,4225,8145,8,230,3158.89,2.6
"2011","Sheffield 042","E02001652","Total",12330,6392,5938,10310,2020,137,154.10,80.0
"2011","Sheffield 043","E02001653","Total",7149,3523,3626,6756,393,27,202.47,35.3
"2011","Sheffield 044","E02001654","Total",6404,3075,3329,6265,139,30,253.20,25.3
"2011","Sheffield 045","E02001655","Total",7655,3684,3971,7621,34,36,200.03,38.3
"2011","Sheffield 046","E02001656","Total",7799,3919,3880,7769,30,115,140.46,55.5
"2011","Sheffield 047","E02001657","Total",8985,4301,4684,8985,0,229,175.83,51.1
"2011","Sheffield 048","E02001658","Total",5380,2520,2860,5360,20,16,101.72,52.9
"2011","Sheffield 049","E02001659","Total",6124,3038,3086,6063,61,17,230.70,26.5
"2011","Sheffield 050","E02001660","Total",9831,5037,4794,9702,129,150,145.72,67.5
"2011","Sheffield 051","E02001661","Total",7849,3830,4019,7717,132,44,154.85,50.7
"2011","Sheffield 052","E02001662","Total",7644,3667,3977,7523,121,38,162.01,47.2
"2011","Sheffield 053","E02001663","Total",7694,3821,3873,7616,78,77,139.75,55.1
"2011","Sheffield 054","E02001664","Total",6158,3035,3123,6150,8,38,125.01,49.3
"2011","Sheffield 055","E02001665","Total",9476,4600,4876,9406,70,339,653.35,14.5
"2011","Sheffield 056","E02001666","Total",6195,2997,3198,6187,8,34,215.42,28.8
"2011","Sheffield 059","E02001669","Total",7707,3709,3998,7642,65,73,140.00,55.0
"2011","Sheffield 060","E02001670","Total",5952,2866,3086,5912,40,29,141.95,41.9
"2011","Sheffield 061","E02001671","Total",5965,2910,3055,5965,0,52,197.74,30.2
"2011","Sheffield 062","E02001672","Total",6167,2980,3187,6080,87,29,177.67,34.7
"2011","Sheffield 063","E02001673","Total",5597,2796,2801,5525,72,56,229.10,24.4
"2011","Sheffield 064","E02001674","Total",8704,4251,4453,8612,92,102,486.63,17.9
"2011","Sheffield 065","E02001675","Total",9049,4401,4648,8992,57,46,285.95,31.6
"2011","Sheffield 066","E02001676","Total",6030,2886,3144,5977,53,96,330.77,18.2
"2011","Sheffield 068","E02001678","Total",10018,4786,5232,9960,58,232,1424.76,7.0
"2011","Sheffield 069","E02001679","Total",6273,3016,3257,6273,0,49,124.78,50.3
"2011","Sheffield 070","E02001680","Total",6127,2985,3142,6084,43,16,134.43,45.6
"2011","Sheffield 071","E02001681","Total",7459,3598,3861,7400,59,135,277.44,26.9
"2011","Sheffield 072","E02006803","Total",8798,4368,4430,8798,0,62,582.25,15.1
"2011","Sheffield 073","E02006843","Total",9256,4925,4331,7110,2146,81,114.64,80.7
"2011","Sheffield 074","E02006844","Total",8734,4615,4119,7860,874,80,84.11,103.8
"2011","Sheffield 075","E02006868","Total",12161,6481,5680,12138,23,81,327.89,37.1
"2011","Sheffield 076","E02006869","Total",11191,5392,5799,11065,126,54,363.46,30.8
"2011","Bradford 001","E02002183","Total",5594,2706,2888,5530,64,136,2462.98,2.3
"2011","Bradford 002","E02002184","Total",12945,6067,6878,12655,290,370,742.74,17.4
"2011","Bradford 003","E02002185","Total",5948,2867,3081,5909,39,131,481.90,12.3
"2011","Bradford 004","E02002186","Total",12643,6076,6567,12336,307,141,3708.84,3.4
"2011","Bradford 005","E02002187","Total",5888,2863,3025,5869,19,186,1090.71,5.4
"2011","Bradford 006","E02002188","Total",7726,3780,3946,7680,46,93,1545.45,5.0
"2011","Bradford 007","E02002189","Total",6842,3374,3468,6646,196,78,331.49,20.6
"2011","Bradford 008","E02002190","Total",12001,6047,5954,11966,35,63,650.63,18.4
"2011","Bradford 009","E02002191","Total",9413,4595,4818,9353,60,56,146.33,64.3
"2011","Bradford 010","E02002192","Total",9239,4489,4750,9145,94,226,1484.22,6.2
"2011","Bradford 011","E02002193","Total",6009,2974,3035,6009,0,19,303.98,19.8
"2011","Bradford 012","E02002194","Total",7500,3577,3923,7500,0,58,189.29,39.6
"2011","Bradford 013","E02002195","Total",6393,3116,3277,6340,53,94,745.07,8.6
"2011","Bradford 014","E02002196","Total",6364,3110,3254,6344,20,85,1387.61,4.6
"2011","Bradford 015","E02002197","Total",8517,4260,4257,8474,43,102,814.47,10.5
"2011","Bradford 016","E02002198","Total",8139,3912,4227,8106,33,71,258.51,31.5
"2011","Bradford 017","E02002199","Total",6407,3141,3266,6380,27,83,892.19,7.2
"2011","Bradford 018","E02002200","Total",9216,4470,4746,9063,153,141,492.71,18.7
"2011","Bradford 019","E02002201","Total",12022,5909,6113,11908,114,116,272.35,44.1
"2011","Bradford 020","E02002202","Total",7029,3577,3452,6984,45,78,260.75,27.0
"2011","Bradford 021","E02002203","Total",7655,3733,3922,7655,0,50,227.13,33.7
"2011","Bradford 022","E02002204","Total",11394,5464,5930,11311,83,170,1061.76,10.7
"2011","Bradford 023","E02002205","Total",10113,4969,5144,10035,78,123,4993.75,2.0
"2011","Bradford 024","E02002206","Total",8721,4301,4420,8720,1,53,186.00,46.9
"2011","Bradford 025","E02002207","Total",7375,3719,3656,7303,72,62,131.51,56.1
"2011","Bradford 026","E02002208","Total",7621,3643,3978,7621,0,41,150.04,50.8
"2011","Bradford 027","E02002209","Total",5908,2835,3073,5908,0,24,158.04,37.4
"2011","Bradford 028","E02002210","Total",7627,3698,3929,7579,48,80,139.24,54.8
"2011","Bradford 029","E02002211","Total",7199,3581,3618,6952,247,74,222.15,32.4
"2011","Bradford 030","E02002212","Total",7294,3545,3749,7235,59,64,255.88,28.5
"2011","Bradford 031","E02002213","Total",6745,3246,3499,6745,0,97,2211.69,3.0
"2011","Bradford 032","E02002214","Total",5917,2891,3026,5911,6,55,104.52,56.6
"2011","Bradford 033","E02002215","Total",10515,5259,5256,10499,16,55,109.69,95.9
"2011","Bradford 034","E02002216","Total",9365,4842,4523,9109,256,57,174.81,53.6
"2011","Bradford 035","E02002217","Total",8855,4375,4480,8779,76,52,198.46,44.6
"2011","Bradford 036","E02002218","Total",9354,4537,4817,9346,8,50,322.08,29.0
"2011","Bradford 037","E02002219","Total",7877,3962,3915,7836,41,42,78.20,100.7
"2011","Bradford 038","E02002220","Total",9288,4591,4697,9199,89,49,134.16,69.2
"2011","Bradford 039","E02002221","Total",13576,7249,6327,13430,146,65,304.50,44.6
"2011","Bradford 040","E02002222","Total",8111,3868,4243,7979,132,46,177.81,45.6
"2011","Bradford 041","E02002223","Total",7821,3996,3825,7817,4,63,206.21,37.9
"2011","Bradford 042","E02002224","Total",10589,5374,5215,10487,102,37,103.70,102.1
"2011","Bradford 043","E02002225","Total",8240,4040,4200,8143,97,71,1207.00,6.8
"2011","Bradford 044","E02002226","Total",14938,7974,6964,12494,2444,180,181.99,82.1
"2011","Bradford 045","E02002227","Total",6503,3304,3199,6503,0,24,216.26,30.1
"2011","Bradford 046","E02002228","Total",6795,3375,3420,6670,125,20,252.14,26.9
"2011","Bradford 047","E02002229","Total",8144,3602,4542,7564,580,91,391.34,20.8
"2011","Bradford 048","E02002230","Total",9502,5047,4455,9364,138,67,141.95,66.9
"2011","Bradford 049","E02002231","Total",12757,6239,6518,12708,49,102,275.68,46.3
"2011","Bradford 050","E02002232","Total",6458,3129,3329,6382,76,40,105.92,61.0
"2011","Bradford 051","E02002233","Total",9238,4663,4575,9238,0,57,86.35,107.0
"2011","Bradford 052","E02002234","Total",7933,3775,4158,7814,119,26,163.52,48.5
"2011","Bradford 053","E02002235","Total",7083,3517,3566,7080,3,24,164.72,43.0
"2011","Bradford 054","E02002236","Total",6002,2878,3124,5993,9,42,116.62,51.5
"2011","Bradford 055","E02002237","Total",8304,3970,4334,8252,52,65,142.96,58.1
"2011","Bradford 056","E02002238","Total",6122,2935,3187,6122,0,28,109.63,55.8
"2011","Bradford 057","E02002239","Total",9964,4851,5113,9868,96,56,1226.19,8.1
"2011","Bradford 058","E02002240","Total",10686,5218,5468,10621,65,86,725.00,14.7
"2011","Bradford 059","E02002241","Total",11941,5732,6209,11815,126,76,277.21,43.1
"2011","Bradford 060","E02002242","Total",7751,3739,4012,7712,39,51,382.92,20.2
"2011","Bradford 061","E02002243","Total",9336,4556,4780,9319,17,54,560.77,16.6
"2011","Calderdale 001","E02002244","Total",6011,2922,3089,5948,63,49,923.33,6.5
"2011","Calderdale 002","E02002245","Total",5627,2730,2897,5627,0,29,543.15,10.4
"2011","Calderdale 003","E02002246","Total",9651,4669,4982,9640,11,136,884.25,10.9
"2011","Calderdale 004","E02002247","Total",9374,4520,4854,9360,14,156,9500.43,1.0
"2011","Calderdale 005","E02002248","Total",7523,3669,3854,7494,29,43,230.21,32.7
"2011","Calderdale 006","E02002249","Total",5522,2682,2840,5475,47,31,122.56,45.1
"2011","Calderdale 007","E02002250","Total",8410,4087,4323,8408,2,101,4188.34,2.0
"2011","Calderdale 008","E02002251","Total",7511,3836,3675,7357,154,56,695.28,10.8
"2011","Calderdale 009","E02002252","Total",6025,2891,3134,5993,32,47,579.13,10.4
"2011","Calderdale 010","E02002253","Total",7616,3718,3898,7607,9,37,161.51,47.2
"2011","Calderdale 011","E02002254","Total",5763,2829,2934,5709,54,103,505.07,11.4
"2011","Calderdale 012","E02002255","Total",7836,3972,3864,7735,101,32,138.15,56.7
"2011","Calderdale 013","E02002256","Total",9317,4483,4834,9165,152,107,2452.24,3.8
"2011","Calderdale 014","E02002257","Total",6202,3132,3070,6202,0,34,65.17,95.2
"2011","Calderdale 015","E02002258","Total",8816,4335,4481,8767,49,129,1174.38,7.5
"2011","Calderdale 016","E02002259","Total",6577,3215,3362,6550,27,77,202.39,32.5
"2011","Calderdale 017","E02002260","Total",9114,4511,4603,9078,36,80,249.47,36.5
"2011","Calderdale 018","E02002261","Total",8108,4014,4094,8088,20,58,737.94,11.0
"2011","Calderdale 019","E02002262","Total",7914,3862,4052,7878,36,93,529.06,15.0
"2011","Calderdale 020","E02002263","Total",6697,3209,3488,6661,36,78,1168.22,5.7
"2011","Calderdale 021","E02002264","Total",6995,3340,3655,6898,97,114,236.44,29.6
"2011","Calderdale 022","E02002265","Total",5432,2627,2805,5385,47,73,2238.01,2.4
"2011","Calderdale 023","E02002266","Total",5820,2850,2970,5722,98,64,232.88,25.0
"2011","Calderdale 024","E02002267","Total",8150,3999,4151,8017,133,81,524.20,15.5
"2011","Calderdale 025","E02002268","Total",9888,4739,5149,9820,68,85,700.17,14.1
"2011","Calderdale 026","E02002269","Total",9569,4691,4878,9517,52,116,1455.16,6.6
"2011","Calderdale 027","E02002270","Total",8358,4095,4263,8275,83,159,5955.07,1.4
"2011","Kirklees 001","E02002271","Total",7100,3402,3698,7033,67,65,671.95,10.6
"2011","Kirklees 002","E02002272","Total",9445,4591,4854,9405,40,70,539.06,17.5
"2011","Kirklees 003","E02002273","Total",6174,3046,3128,6136,38,45,768.89,8.0
"2011","Kirklees 004","E02002274","Total",6999,3444,3555,6942,57,64,355.92,19.7
"2011","Kirklees 005","E02002275","Total",8558,4220,4338,8479,79,53,247.97,34.5
"2011","Kirklees 006","E02002276","Total",7281,3611,3670,7199,82,50,307.27,23.7
"2011","Kirklees 007","E02002277","Total",6510,3244,3266,6448,62,43,411.97,15.8
"2011","Kirklees 008","E02002278","Total",6372,3106,3266,6335,37,48,312.86,20.4
"2011","Kirklees 009","E02002279","Total",6174,3035,3139,6140,34,46,311.60,19.8
"2011","Kirklees 010","E02002280","Total",6248,3077,3171,6219,29,25,150.24,41.6
"2011","Kirklees 011","E02002281","Total",11399,5609,5790,11318,81,56,226.55,50.3
"2011","Kirklees 012","E02002282","Total",7203,3636,3567,7195,8,35,114.50,62.9
"2011","Kirklees 013","E02002283","Total",7833,3952,3881,7822,11,38,161.63,48.5
"2011","Kirklees 014","E02002284","Total",6054,3012,3042,6049,5,39,289.32,20.9
"2011","Kirklees 015","E02002285","Total",7991,3943,4048,7898,93,68,813.15,9.8
"2011","Kirklees 016","E02002286","Total",6076,2992,3084,6059,17,33,148.36,41.0
"2011","Kirklees 017","E02002287","Total",6933,3574,3359,6725,208,57,189.21,36.6
"2011","Kirklees 018","E02002288","Total",9273,4519,4754,9201,72,46,309.71,29.9
"2011","Kirklees 019","E02002289","Total",6560,3282,3278,6499,61,29,203.71,32.2
"2011","Kirklees 020","E02002290","Total",6229,2996,3233,6218,11,91,354.91,17.6
"2011","Kirklees 021","E02002291","Total",6552,3161,3391,6446,106,61,215.77,30.4
"2011","Kirklees 022","E02002292","Total",5708,2797,2911,5686,22,73,524.86,10.9
"2011","Kirklees 023","E02002293","Total",7932,3972,3960,7899,33,29,241.69,32.8
"2011","Kirklees 024","E02002294","Total",10691,5433,5258,10492,199,68,344.11,31.1
"2011","Kirklees 025","E02002295","Total",6692,3140,3552,6672,20,36,277.29,24.1
"2011","Kirklees 026","E02002296","Total",6782,3301,3481,6708,74,70,782.41,8.7
"2011","Kirklees 027","E02002297","Total",6899,3437,3462,6899,0,116,464.44,14.9
"2011","Kirklees 028","E02002298","Total",6748,3277,3471,6706,42,70,962.07,7.0
"2011","Kirklees 029","E02002299","Total",6550,3349,3201,6410,140,55,404.19,16.2
"2011","Kirklees 030","E02002300","Total",6683,3195,3488,6652,31,111,259.85,25.7
"2011","Kirklees 031","E02002301","Total",7655,3980,3675,7644,11,50,114.94,66.6
"2011","Kirklees 032","E02002302","Total",6386,3107,3279,6348,38,56,857.48,7.4
"2011","Kirklees 033","E02002303","Total",6469,3066,3403,6380,89,67,153.68,42.1
"2011","Kirklees 034","E02002304","Total",6542,3402,3140,6405,137,62,161.87,40.4
"2011","Kirklees 035","E02002305","Total",6071,2970,3101,6061,10,30,180.64,33.6
"2011","Kirklees 036","E02002306","Total",6363,3113,3250,6344,19,91,734.50,8.7
"2011","Kirklees 037","E02002307","Total",6004,2939,3065,5978,26,44,243.38,24.7
"2011","Kirklees 038","E02002308","Total",6459,3172,3287,6441,18,46,229.45,28.1
"2011","Kirklees 039","E02002309","Total",6767,3454,3313,6664,103,35,188.90,35.8
"2011","Kirklees 040","E02002310","Total",6083,2941,3142,6028,55,55,120.61,50.4
"2011","Kirklees 041","E02002311","Total",6427,3154,3273,6314,113,60,209.86,30.6
"2011","Kirklees 042","E02002312","Total",8137,4194,3943,6727,1410,70,287.19,28.3
"2011","Kirklees 043","E02002313","Total",7663,4019,3644,7610,53,43,102.71,74.6
"2011","Kirklees 044","E02002314","Total",6009,2907,3102,5967,42,61,412.89,14.6
"2011","Kirklees 045","E02002315","Total",6775,3370,3405,6745,30,48,240.23,28.2
"2011","Kirklees 046","E02002316","Total",6435,3120,3315,6435,0,73,1487.71,4.3
"2011","Kirklees 047","E02002317","Total",7042,3365,3677,7039,3,48,208.71,33.7
"2011","Kirklees 048","E02002318","Total",6404,3091,3313,6308,96,46,321.60,19.9
"2011","Kirklees 049","E02002319","Total",6549,3273,3276,6508,41,52,583.00,11.2
"2011","Kirklees 050","E02002320","Total",6398,3163,3235,6385,13,86,557.27,11.5
"2011","Kirklees 051","E02002321","Total",7232,3587,3645,6027,1205,148,1910.72,3.8
"2011","Kirklees 052","E02002322","Total",6401,3118,3283,6398,3,72,5195.70,1.2
"2011","Kirklees 053","E02002323","Total",8443,4144,4299,8426,17,129,1131.35,7.5
"2011","Kirklees 054","E02002324","Total",6520,3198,3322,6477,43,86,1770.05,3.7
"2011","Kirklees 055","E02002325","Total",8534,4135,4399,8419,115,101,2350.20,3.6
"2011","Kirklees 056","E02002326","Total",6264,3073,3191,6264,0,130,1345.38,4.7
"2011","Kirklees 057","E02002327","Total",9845,4871,4974,9776,69,164,2345.26,4.2
"2011","Kirklees 058","E02002328","Total",6976,3465,3511,6886,90,135,3425.83,2.0
"2011","Kirklees 059","E02002329","Total",11956,5913,6043,11946,10,236,2623.08,4.6
"2011","Leeds 001","E02002330","Total",6598,3199,3399,6592,6,154,337.08,19.6
"2011","Leeds 002","E02002331","Total",6592,3642,2950,5507,1085,79,2155.00,3.1
"2011","Leeds 003","E02002332","Total",5849,2789,3060,5849,0,79,291.08,20.1
"2011","Leeds 004","E02002333","Total",7819,3787,4032,7729,90,126,898.24,8.7
"2011","Leeds 005","E02002334","Total",7116,3374,3742,7083,33,152,2540.69,2.8
"2011","Leeds 006","E02002335","Total",7552,3693,3859,7552,0,202,5207.46,1.5
"2011","Leeds 007","E02002336","Total",6765,3332,3433,6734,31,148,2879.81,2.3
"2011","Leeds 008","E02002337","Total",6712,3269,3443,6685,27,129,1488.29,4.5
"2011","Leeds 009","E02002338","Total",6800,3323,3477,6729,71,82,212.62,32.0
"2011","Leeds 010","E02002339","Total",5719,2757,2962,5634,85,47,141.35,40.5
"2011","Leeds 011","E02002340","Total",5536,2671,2865,5519,17,61,217.63,25.4
"2011","Leeds 012","E02002341","Total",7348,3573,3775,7348,0,186,1341.22,5.5
"2011","Leeds 013","E02002342","Total",5752,2782,2970,5752,0,93,303.09,19.0
"2011","Leeds 014","E02002343","Total",5729,2744,2985,5729,0,99,286.03,20.0
"2011","Leeds 015","E02002344","Total",7678,3606,4072,7653,25,142,186.94,41.1
"2011","Leeds 016","E02002345","Total",5503,2679,2824,5475,28,150,529.67,10.4
"2011","Leeds 017","E02002346","Total",5982,2880,3102,5982,0,59,147.44,40.6
"2011","Leeds 018","E02002347","Total",5998,2845,3153,5971,27,82,187.71,32.0
"2011","Leeds 019","E02002348","Total",6111,2899,3212,6054,57,73,237.81,25.7
"2011","Leeds 020","E02002349","Total",5637,2718,2919,5554,83,132,462.40,12.2
"2011","Leeds 021","E02002350","Total",6201,3036,3165,5973,228,108,393.75,15.7
"2011","Leeds 022","E02002351","Total",5399,2626,2773,5380,19,105,1696.39,3.2
"2011","Leeds 023","E02002352","Total",7371,3627,3744,7362,9,145,161.63,45.6
"2011","Leeds 024","E02002353","Total",5817,2888,2929,5781,36,139,124.58,46.7
"2011","Leeds 025","E02002354","Total",7825,3787,4038,7782,43,107,199.39,39.2
"2011","Leeds 027","E02002356","Total",7521,3608,3913,7361,160,116,586.73,12.8
"2011","Leeds 028","E02002357","Total",7784,3750,4034,7755,29,77,176.00,44.2
"2011","Leeds 029","E02002358","Total",7353,3567,3786,7341,12,60,295.50,24.9
"2011","Leeds 030","E02002359","Total",6393,3081,3312,6393,0,111,4492.28,1.4
"2011","Leeds 031","E02002360","Total",6748,3193,3555,6731,17,85,162.67,41.5
"2011","Leeds 032","E02002361","Total",5746,2737,3009,5653,93,120,192.28,29.9
"2011","Leeds 033","E02002362","Total",7695,3718,3977,7658,37,69,254.52,30.2
"2011","Leeds 034","E02002363","Total",6976,3321,3655,6901,75,85,141.72,49.2
"2011","Leeds 035","E02002364","Total",5768,2730,3038,5706,62,48,159.50,36.2
"2011","Leeds 037","E02002366","Total",7767,3756,4011,7577,190,95,230.46,33.7
"2011","Leeds 038","E02002367","Total",5915,2778,3137,5915,0,25,178.96,33.1
"2011","Leeds 039","E02002368","Total",7952,3880,4072,7893,59,87,785.73,10.1
"2011","Leeds 040","E02002369","Total",6939,3315,3624,6892,47,47,171.17,40.5
"2011","Leeds 041","E02002370","Total",6653,3110,3543,6620,33,25,198.75,33.5
"2011","Leeds 042","E02002371","Total",9614,4643,4971,9594,20,108,176.80,54.4
"2011","Leeds 044","E02002373","Total",8559,4307,4252,8448,111,94,86.57,98.9
"2011","Leeds 045","E02002374","Total",6636,3300,3336,6542,94,51,167.23,39.7
"2011","Leeds 046","E02002375","Total",6386,3097,3289,5393,993,46,245.00,26.1
"2011","Leeds 047","E02002376","Total",6869,3315,3554,6845,24,74,110.57,62.1
"2011","Leeds 048","E02002377","Total",7067,3626,3441,7033,34,22,50.87,138.9
"2011","Leeds 050","E02002379","Total",5243,2444,2799,5243,0,27,124.86,42.0
"2011","Leeds 051","E02002380","Total",5270,2570,2700,5265,5,33,135.13,39.0
"2011","Leeds 052","E02002381","Total",6103,2997,3106,6095,8,43,215.54,28.3
"2011","Leeds 053","E02002382","Total",6001,3054,2947,5990,11,39,47.19,127.2
"2011","Leeds 054","E02002383","Total",7636,3762,3874,7512,124,72,40.87,186.8
"2011","Leeds 055","E02002384","Total",10792,5531,5261,8538,2254,107,195.48,55.2
"2011","Leeds 056","E02002385","Total",7996,4239,3757,7959,37,28,134.07,59.6
"2011","Leeds 057","E02002386","Total",8343,3989,4354,8307,36,77,697.68,12.0
"2011","Leeds 058","E02002387","Total",5455,2597,2858,5450,5,28,117.21,46.5
"2011","Leeds 059","E02002388","Total",7357,3536,3821,7299,58,25,181.17,40.6
"2011","Leeds 060","E02002389","Total",6600,3172,3428,6600,0,36,203.31,32.5
"2011","Leeds 061","E02002390","Total",6055,2866,3189,6055,0,36,177.52,34.1
"2011","Leeds 062","E02002391","Total",7772,3735,4037,7749,23,43,216.19,35.9
"2011","Leeds 063","E02002392","Total",9275,4434,4841,5168,4107,141,133.10,69.7
"2011","Leeds 064","E02002393","Total",7589,4067,3522,7519,70,43,138.61,54.8
"2011","Leeds 065","E02002394","Total",6773,3392,3381,6770,3,33,107.57,63.0
"2011","Leeds 066","E02002395","Total",6340,3069,3271,6321,19,69,291.35,21.8
"2011","Leeds 067","E02002396","Total",8466,4259,4207,8375,91,69,209.51,40.4
"2011","Leeds 068","E02002397","Total",7430,3585,3845,7397,33,51,182.64,40.7
"2011","Leeds 069","E02002398","Total",7443,3654,3789,7431,12,73,793.71,9.4
"2011","Leeds 070","E02002399","Total",6204,2942,3262,6183,21,19,393.64,15.8
"2011","Leeds 071","E02002400","Total",8222,4405,3817,7644,578,19,258.26,31.8
"2011","Leeds 072","E02002401","Total",6203,2930,3273,6203,0,49,376.01,16.5
"2011","Leeds 073","E02002402","Total",5774,2851,2923,5755,19,84,422.73,13.7
"2011","Leeds 074","E02002403","Total",6071,2857,3214,5975,96,70,241.41,25.1
"2011","Leeds 075","E02002404","Total",8676,4545,4131,8225,451,30,173.53,50.0
"2011","Leeds 076","E02002405","Total",7484,3568,3916,7386,98,69,468.13,16.0
"2011","Leeds 077","E02002406","Total",7018,3393,3625,7007,11,75,254.10,27.6
"2011","Leeds 078","E02002407","Total",6389,3080,3309,6273,116,20,130.93,48.8
"2011","Leeds 079","E02002408","Total",7237,3380,3857,7112,125,55,286.61,25.3
"2011","Leeds 080","E02002409","Total",5940,2879,3061,5919,21,41,485.16,12.2
"2011","Leeds 081","E02002410","Total",6591,3297,3294,6500,91,37,211.27,31.2
"2011","Leeds 082","E02002411","Total",7054,3869,3185,6951,103,25,214.79,32.8
"2011","Leeds 083","E02002412","Total",6798,3324,3474,6791,7,40,492.32,13.8
"2011","Leeds 085","E02002414","Total",5725,2931,2794,5674,51,18,131.11,43.7
"2011","Leeds 086","E02002415","Total",6483,3463,3020,6482,1,31,71.96,90.1
"2011","Leeds 087","E02002416","Total",6319,3038,3281,6302,17,48,1540.64,4.1
"2011","Leeds 088","E02002417","Total",6327,3129,3198,6292,35,53,2502.12,2.5
"2011","Leeds 089","E02002418","Total",7234,3545,3689,7234,0,76,254.87,28.4
"2011","Leeds 090","E02002419","Total",7832,3787,4045,7832,0,43,292.38,26.8
"2011","Leeds 091","E02002420","Total",7853,3839,4014,7822,31,49,200.65,39.1
"2011","Leeds 092","E02002421","Total",5931,2792,3139,5897,34,29,138.66,42.8
"2011","Leeds 093","E02002422","Total",6180,3007,3173,6137,43,41,298.45,20.7
"2011","Leeds 094","E02002423","Total",5641,2753,2888,5606,35,17,153.03,36.9
"2011","Leeds 095","E02002424","Total",7612,3720,3892,7565,47,57,413.25,18.4
"2011","Leeds 096","E02002425","Total",8448,4131,4317,8367,81,60,602.47,14.0
"2011","Leeds 097","E02002426","Total",7661,3754,3907,7639,22,70,360.76,21.2
"2011","Leeds 098","E02002427","Total",6854,3244,3610,6805,49,62,189.50,36.2
"2011","Leeds 099","E02002428","Total",6878,3304,3574,6867,11,35,381.81,18.0
"2011","Leeds 100","E02002429","Total",8245,3954,4291,8178,67,62,1665.71,4.9
"2011","Leeds 101","E02002430","Total",7175,3380,3795,7141,34,27,268.89,26.7
"2011","Leeds 102","E02002431","Total",7992,3895,4097,7955,37,61,321.78,24.8
"2011","Leeds 103","E02002432","Total",7200,3495,3705,7083,117,41,1102.15,6.5
"2011","Leeds 104","E02002433","Total",6177,2993,3184,6145,32,29,152.10,40.6
"2011","Leeds 105","E02002434","Total",8621,4213,4408,8563,58,61,590.89,14.6
"2011","Leeds 106","E02002435","Total",7394,3630,3764,7379,15,60,809.99,9.1
"2011","Leeds 107","E02002436","Total",6605,3238,3367,6552,53,46,601.18,11.0
"2011","Leeds 108","E02002437","Total",6190,3024,3166,6190,0,83,521.91,11.9
"2011","Leeds 109","E02006852","Total",12417,6152,6265,10563,1854,249,443.79,28.0
"2011","Leeds 110","E02006861","Total",12512,6126,6386,10488,2024,151,146.76,85.3
"2011","Leeds 111","E02006875","Total",7484,4122,3362,5493,1991,87,251.94,29.7
"2011","Leeds 112","E02006876","Total",7145,3646,3499,6495,650,24,521.48,13.7
"2011","Wakefield 001","E02002438","Total",7871,3833,4038,7759,112,40,494.21,15.9
"2011","Wakefield 002","E02002439","Total",7639,3748,3891,7593,46,43,307.76,24.8
"2011","Wakefield 003","E02002440","Total",7751,3761,3990,7735,16,71,269.87,28.7
"2011","Wakefield 004","E02002441","Total",8626,4251,4375,8483,143,57,273.55,31.5
"2011","Wakefield 005","E02002442","Total",6713,3334,3379,6671,42,59,385.92,17.4
"2011","Wakefield 006","E02002443","Total",5943,2954,2989,5819,124,76,368.35,16.1
"2011","Wakefield 007","E02002444","Total",5881,2857,3024,5874,7,57,925.13,6.4
"2011","Wakefield 008","E02002445","Total",7004,3410,3594,6845,159,70,341.95,20.5
"2011","Wakefield 009","E02002446","Total",6038,2960,3078,5983,55,61,711.74,8.5
"2011","Wakefield 010","E02002447","Total",6146,3065,3081,6059,87,30,540.02,11.4
"2011","Wakefield 011","E02002448","Total",7564,3665,3899,7528,36,30,759.65,10.0
"2011","Wakefield 012","E02002449","Total",8138,3984,4154,8063,75,73,448.89,18.1
"2011","Wakefield 013","E02002450","Total",6757,3345,3412,6711,46,54,489.79,13.8
"2011","Wakefield 014","E02002451","Total",7186,3470,3716,7037,149,113,567.32,12.7
"2011","Wakefield 015","E02002452","Total",7963,3952,4011,7846,117,70,765.11,10.4
"2011","Wakefield 016","E02002453","Total",9248,4511,4737,9179,69,57,1020.36,9.1
"2011","Wakefield 017","E02002454","Total",7553,3983,3570,7406,147,62,228.27,33.1
"2011","Wakefield 018","E02002455","Total",6149,2913,3236,6149,0,46,258.09,23.8
"2011","Wakefield 019","E02002456","Total",7166,3957,3209,6416,750,53,176.85,40.5
"2011","Wakefield 020","E02002457","Total",7603,3700,3903,7569,34,50,171.90,44.2
"2011","Wakefield 021","E02002458","Total",8809,4272,4537,8746,63,81,698.34,12.6
"2011","Wakefield 022","E02002459","Total",9349,4586,4763,9292,57,87,390.82,23.9
"2011","Wakefield 023","E02002460","Total",7055,3423,3632,7029,26,114,360.86,19.6
"2011","Wakefield 024","E02002461","Total",10059,4877,5182,9931,128,74,1582.00,6.4
"2011","Wakefield 025","E02002462","Total",7307,3571,3736,7288,19,77,526.62,13.9
"2011","Wakefield 026","E02002463","Total",9104,4293,4811,9049,55,48,242.43,37.6
"2011","Wakefield 027","E02002464","Total",7848,3800,4048,7836,12,26,692.57,11.3
"2011","Wakefield 028","E02002465","Total",5988,2971,3017,5984,4,53,416.20,14.4
"2011","Wakefield 029","E02002466","Total",8986,4361,4625,8976,10,62,336.67,26.7
"2011","Wakefield 030","E02002467","Total",8234,4182,4052,8203,31,37,427.95,19.2
"2011","Wakefield 031","E02002468","Total",6046,2901,3145,5984,62,60,319.28,18.9
"2011","Wakefield 032","E02002469","Total",5945,2931,3014,5945,0,56,1520.66,3.9
"2011","Wakefield 033","E02002470","Total",6144,2981,3163,6097,47,152,406.80,15.1
"2011","Wakefield 034","E02002471","Total",10404,5114,5290,10302,102,155,4234.16,2.5
"2011","Wakefield 035","E02002472","Total",5963,2776,3187,5648,315,63,1381.05,4.3
"2011","Wakefield 036","E02002473","Total",6336,3086,3250,6309,27,67,758.74,8.4
"2011","Wakefield 037","E02002474","Total",6115,2988,3127,6064,51,57,464.17,13.2
"2011","Wakefield 038","E02002475","Total",5975,2894,3081,5933,42,113,3770.75,1.6
"2011","Wakefield 039","E02002476","Total",5845,2864,2981,5732,113,25,971.37,6.0
"2011","Wakefield 040","E02002477","Total",6321,3093,3228,6294,27,45,1170.37,5.4
"2011","Wakefield 041","E02002478","Total",5832,2889,2943,5818,14,58,1330.92,4.4
"2011","Wakefield 042","E02002479","Total",8334,4090,4244,8314,20,44,729.59,11.4
"2011","Wakefield 043","E02002480","Total",5872,2910,2962,5860,12,41,229.44,25.6
"2011","Wakefield 044","E02002481","Total",6325,3127,3198,6263,62,41,622.83,10.2
"2011","Wakefield 045","E02002482","Total",6702,3280,3422,6642,60,35,771.92,8.7
"2011","Derby 001","E02002796","Total",6135,2973,3162,6135,0,138,335.04,18.3
"2011","Derby 002","E02002797","Total",7487,3625,3862,7486,1,119,312.57,24.0
"2011","Derby 003","E02002798","Total",10138,4998,5140,10090,48,122,237.82,42.6
"2011","Derby 004","E02002799","Total",5992,2899,3093,5992,0,17,208.16,28.8
"2011","Derby 005","E02002800","Total",7131,3474,3657,6969,162,128,322.17,22.1
"2011","Derby 006","E02002801","Total",7611,3691,3920,7602,9,40,159.78,47.6
"2011","Derby 007","E02002802","Total",8012,3874,4138,7921,91,35,301.74,26.6
"2011","Derby 008","E02002803","Total",7766,4171,3595,6474,1292,101,193.15,40.2
"2011","Derby 009","E02002804","Total",7633,3623,4010,7628,5,44,209.55,36.4
"2011","Derby 010","E02002805","Total",5701,2813,2888,5668,33,55,223.09,25.6
"2011","Derby 011","E02002806","Total",6547,3501,3046,6189,358,35,76.48,85.6
"2011","Derby 012","E02002807","Total",9021,4426,4595,8978,43,58,280.51,32.2
"2011","Derby 013","E02002808","Total",11819,6234,5585,11255,564,71,221.75,53.3
"2011","Derby 014","E02002809","Total",6676,3251,3425,6599,77,37,573.92,11.6
"2011","Derby 015","E02002810","Total",8220,3967,4253,8180,40,143,291.94,28.2
"2011","Derby 016","E02002811","Total",9971,5247,4724,9843,128,77,99.71,100.0
"2011","Derby 017","E02002812","Total",6965,3422,3543,6735,230,104,254.22,27.4
"2011","Derby 018","E02002813","Total",10322,5389,4933,10164,158,44,185.25,55.7
"2011","Derby 019","E02002814","Total",7360,3508,3852,7285,75,110,213.70,34.4
"2011","Derby 020","E02002815","Total",7664,3865,3799,7630,34,63,83.43,91.9
"2011","Derby 021","E02002816","Total",9406,4614,4792,9357,49,227,335.06,28.1
"2011","Derby 022","E02002817","Total",6317,3025,3292,6248,69,92,168.69,37.4
"2011","Derby 023","E02002818","Total",7665,3721,3944,7469,196,40,129.21,59.3
"2011","Derby 024","E02002819","Total",7408,3742,3666,7241,167,49,513.15,14.4
"2011","Derby 025","E02002820","Total",9708,4809,4899,9694,14,64,171.93,56.5
"2011","Derby 026","E02002821","Total",11010,5319,5691,10965,45,44,290.78,37.9
"2011","Derby 027","E02002822","Total",6738,3209,3529,6708,30,76,167.23,40.3
"2011","Derby 028","E02002823","Total",7475,3586,3889,7424,51,37,194.31,38.5
"2011","Derby 029","E02002824","Total",9656,4698,4958,9618,38,73,539.98,17.9
"2011","Derby 030","E02002825","Total",8544,4174,4370,8427,117,83,279.59,30.6
"2011","Derby 031","E02002826","Total",6654,3198,3456,6651,3,105,229.20,29.0
"2011","Leicester 001","E02002827","Total",6431,3181,3250,6398,33,77,497.90,12.9
"2011","Leicester 002","E02002828","Total",7582,3739,3843,7563,19,105,368.95,20.6
"2011","Leicester 003","E02002829","Total",10609,5145,5464,10494,115,41,307.20,34.5
"2011","Leicester 004","E02002830","Total",10049,5039,5010,9984,65,91,391.44,25.7
"2011","Leicester 005","E02002831","Total",6832,3354,3478,6755,77,83,125.06,54.6
"2011","Leicester 006","E02002832","Total",8072,3930,4142,7943,129,108,133.92,60.3
"2011","Leicester 007","E02002833","Total",8160,4023,4137,8149,11,114,85.50,95.4
"2011","Leicester 008","E02002834","Total",9731,4889,4842,9731,0,94,315.84,30.8
"2011","Leicester 009","E02002835","Total",12628,6207,6421,12533,95,142,370.83,34.1
"2011","Leicester 010","E02002836","Total",9331,4512,4819,9319,12,129,117.26,79.6
"2011","Leicester 011","E02002837","Total",7445,3725,3720,7409,36,40,112.31,66.3
"2011","Leicester 012","E02002838","Total",7723,3618,4105,7666,57,49,183.52,42.1
"2011","Leicester 013","E02002839","Total",7638,3685,3953,7576,62,65,145.11,52.6
"2011","Leicester 016","E02002842","Total",7658,3896,3762,7628,30,34,78.65,97.4
"2011","Leicester 017","E02002843","Total",13049,6569,6480,12961,88,80,97.21,134.2
"2011","Leicester 018","E02002844","Total",11954,5986,5968,11927,27,63,96.41,124.0
"2011","Leicester 019","E02002845","Total",10350,5109,5241,10230,120,86,222.52,46.5
"2011","Leicester 020","E02002846","Total",7385,3629,3756,7301,84,109,276.39,26.7
"2011","Leicester 021","E02002847","Total",10274,5229,5045,10260,14,126,138.60,74.1
"2011","Leicester 022","E02002848","Total",11199,5844,5355,11026,173,117,52.83,212.0
"2011","Leicester 023","E02002849","Total",12432,6354,6078,11698,734,133,126.06,98.6
"2011","Leicester 025","E02002851","Total",7984,3876,4108,7896,88,168,317.65,25.1
"2011","Leicester 026","E02002852","Total",7098,3398,3700,7098,0,54,207.29,34.2
"2011","Leicester 027","E02002853","Total",12799,6495,6304,12703,96,211,140.82,90.9
"2011","Leicester 028","E02002854","Total",8224,3934,4290,8077,147,37,148.49,55.4
"2011","Leicester 029","E02002855","Total",6583,3384,3199,6571,12,57,149.10,44.2
"2011","Leicester 030","E02002856","Total",11621,5764,5857,11134,487,137,258.98,44.9
"2011","Leicester 031","E02002857","Total",6230,3084,3146,6150,80,39,154.56,40.3
"2011","Leicester 032","E02002858","Total",7464,3575,3889,7136,328,204,211.04,35.4
"2011","Leicester 034","E02002860","Total",7944,3937,4007,7737,207,73,330.59,24.0
"2011","Leicester 035","E02002861","Total",7752,3646,4106,7734,18,31,163.00,47.6
"2011","Leicester 036","E02002862","Total",8317,3901,4416,8266,51,30,136.30,61.0
"2011","Leicester 037","E02006815","Total",9184,4393,4791,9111,73,41,210.60,43.6
"2011","Leicester 038","E02006817","Total",8111,3955,4156,7507,604,122,215.06,37.7
"2011","Leicester 039","E02006819","Total",8109,3897,4212,8046,63,35,203.41,39.9
"2011","Leicester 040","E02006850","Total",9855,4769,5086,6895,2960,156,116.24,84.8
"2011","Leicester 041","E02006851","Total",6032,3213,2819,4915,1117,51,124.84,48.3
"2011","Nottingham 001","E02002868","Total",5773,2778,2995,5771,2,56,157.42,36.7
"2011","Nottingham 002","E02002869","Total",7425,3443,3982,7299,126,20,292.22,25.4
"2011","Nottingham 004","E02002871","Total",7841,3841,4000,7767,74,59,173.94,45.1
"2011","Nottingham 005","E02002872","Total",8732,4226,4506,8644,88,28,244.24,35.8
"2011","Nottingham 006","E02002873","Total",9042,4364,4678,8983,59,25,160.77,56.2
"2011","Nottingham 007","E02002874","Total",7958,4010,3948,7288,670,92,185.99,42.8
"2011","Nottingham 008","E02002875","Total",8250,3968,4282,8190,60,41,151.82,54.3
"2011","Nottingham 009","E02002876","Total",7957,3903,4054,7760,197,61,226.51,35.1
"2011","Nottingham 010","E02002877","Total",7527,3795,3732,7370,157,74,150.46,50.0
"2011","Nottingham 011","E02002878","Total",8983,4165,4818,8983,0,34,163.13,55.1
"2011","Nottingham 012","E02002879","Total",9107,4542,4565,8881,226,66,146.31,62.2
"2011","Nottingham 013","E02002880","Total",8639,4110,4529,8639,0,51,118.74,72.8
"2011","Nottingham 014","E02002881","Total",6175,2923,3252,6139,36,31,196.87,31.4
"2011","Nottingham 015","E02002882","Total",8201,4224,3977,7681,520,131,200.43,40.9
"2011","Nottingham 016","E02002883","Total",7574,3806,3768,7483,91,73,143.31,52.9
"2011","Nottingham 017","E02002884","Total",6131,3306,2825,5953,178,38,63.05,97.2
"2011","Nottingham 018","E02002885","Total",8149,4285,3864,8126,23,45,74.53,109.3
"2011","Nottingham 019","E02002886","Total",8785,4397,4388,8785,0,70,234.66,37.4
"2011","Nottingham 020","E02002887","Total",6463,3058,3405,6316,147,51,213.06,30.3
"2011","Nottingham 021","E02002888","Total",6554,3257,3297,6550,4,17,111.52,58.8
"2011","Nottingham 022","E02002889","Total",8585,4526,4059,6871,1714,76,136.85,62.7
"2011","Nottingham 023","E02002890","Total",11170,5880,5290,9170,2000,139,118.94,93.9
"2011","Nottingham 024","E02002891","Total",8332,4116,4216,8315,17,31,247.07,33.7
"2011","Nottingham 025","E02002892","Total",6071,2903,3168,6071,0,44,171.66,35.4
"2011","Nottingham 026","E02002893","Total",13419,7122,6297,10458,2961,143,125.58,106.9
"2011","Nottingham 027","E02002894","Total",6845,3420,3425,6833,12,128,294.34,23.3
"2011","Nottingham 028","E02002895","Total",7995,4429,3566,7959,36,90,116.07,68.9
"2011","Nottingham 029","E02002896","Total",10014,5347,4667,9948,66,71,291.81,34.3
"2011","Nottingham 030","E02002897","Total",7896,3847,4049,7896,0,164,259.94,30.4
"2011","Nottingham 031","E02002898","Total",10920,6022,4898,10691,229,78,521.27,20.9
"2011","Nottingham 032","E02002899","Total",9952,4995,4957,5038,4914,198,287.74,34.6
"2011","Nottingham 034","E02002901","Total",5735,2834,2901,5696,39,69,204.72,28.0
"2011","Nottingham 035","E02002902","Total",8620,4194,4426,7881,739,74,285.75,30.2
"2011","Nottingham 036","E02002903","Total",6343,3060,3283,6334,9,53,276.84,22.9
"2011","Nottingham 037","E02002904","Total",6137,2986,3151,6137,0,15,128.19,47.9
"2011","Nottingham 038","E02006834","Total",7711,3658,4053,7664,47,41,133.34,57.8
"2011","Nottingham 039","E02006904","Total",7050,4029,3021,6965,85,43,210.99,33.4
"2011","Nottingham 040","E02006905","Total",7619,4008,3611,7203,416,36,241.08,31.6
"2011","Rutland 001","E02002863","Total",7812,4458,3354,6375,1437,157,14418.84,0.5
"2011","Rutland 002","E02002864","Total",5851,2843,3008,5793,58,103,3585.46,1.6
"2011","Rutland 003","E02002865","Total",7902,3788,4114,7470,432,175,537.72,14.7
"2011","Rutland 004","E02002866","Total",7384,3657,3727,7240,144,173,8429.24,0.9
"2011","Rutland 005","E02002867","Total",8420,4169,4251,7374,1046,234,11180.25,0.8
"2011","Amber Valley 001","E02004029","Total",6459,3206,3253,6360,99,51,424.80,15.2
"2011","Amber Valley 002","E02004030","Total",5630,2759,2871,5592,38,88,4022.25,1.4
"2011","Amber Valley 003","E02004031","Total",7474,3603,3871,7387,87,23,683.22,10.9
"2011","Amber Valley 004","E02004032","Total",8261,4089,4172,8229,32,99,631.05,13.1
"2011","Amber Valley 005","E02004033","Total",8824,4382,4442,8661,163,63,1059.68,8.3
"2011","Amber Valley 006","E02004034","Total",7326,3576,3750,7260,66,72,1002.73,7.3
"2011","Amber Valley 007","E02004035","Total",6475,3250,3225,6404,71,107,5532.70,1.2
"2011","Amber Valley 008","E02004036","Total",9919,4907,5012,9910,9,65,557.15,17.8
"2011","Amber Valley 009","E02004037","Total",7670,3811,3859,7670,0,116,329.76,23.3
"2011","Amber Valley 010","E02004038","Total",7797,3752,4045,7573,224,69,655.96,11.9
"2011","Amber Valley 011","E02004039","Total",8044,3969,4075,7988,56,79,903.33,8.9
"2011","Amber Valley 012","E02004040","Total",9016,4455,4561,8955,61,64,1204.18,7.5
"2011","Amber Valley 013","E02004041","Total",7029,3506,3523,6954,75,63,226.93,31.0
"2011","Amber Valley 015","E02004043","Total",7025,3419,3606,6977,48,86,2022.80,3.5
"2011","Amber Valley 016","E02004044","Total",7717,3787,3930,7629,88,244,5823.44,1.3
"2011","Amber Valley 017","E02006827","Total",7643,3721,3922,7618,25,49,1458.50,5.2
"2011","Bolsover 001","E02004045","Total",9092,4523,4569,9036,56,96,2113.14,4.3
"2011","Bolsover 002","E02004046","Total",6221,3046,3175,6195,26,37,2422.69,2.6
"2011","Bolsover 003","E02004047","Total",5651,2758,2893,5554,97,30,877.32,6.4
"2011","Bolsover 004","E02004048","Total",6687,3316,3371,6662,25,39,1632.28,4.1
"2011","Bolsover 005","E02004049","Total",7781,3750,4031,7703,78,59,1051.20,7.4
"2011","Bolsover 006","E02004050","Total",7045,3412,3633,6989,56,34,317.58,22.2
"2011","Bolsover 007","E02004051","Total",9016,4435,4581,8930,86,48,2868.91,3.1
"2011","Bolsover 008","E02004052","Total",7868,3865,4003,7794,74,60,3317.77,2.4
"2011","Bolsover 009","E02004053","Total",7877,3921,3956,7835,42,37,558.05,14.1
"2011","Bolsover 010","E02004054","Total",8628,4362,4266,8553,75,60,874.10,9.9
"2011","Chesterfield 001","E02004055","Total",7127,3501,3626,7040,87,45,764.85,9.3
"2011","Chesterfield 002","E02004056","Total",7802,3838,3964,7752,50,57,1060.57,7.4
"2011","Chesterfield 003","E02004057","Total",7675,3813,3862,7616,59,38,979.33,7.8
"2011","Chesterfield 004","E02004058","Total",7814,3760,4054,7732,82,56,481.83,16.2
"2011","Chesterfield 005","E02004059","Total",7261,3483,3778,7100,161,83,617.28,11.8
"2011","Chesterfield 006","E02004060","Total",7632,3710,3922,7554,78,50,685.49,11.1
"2011","Chesterfield 007","E02004061","Total",7186,3614,3572,7136,50,66,219.87,32.7
"2011","Chesterfield 008","E02004062","Total",7992,3916,4076,7949,43,142,299.03,26.7
"2011","Chesterfield 009","E02004063","Total",7973,3854,4119,7912,61,110,197.80,40.3
"2011","Chesterfield 010","E02004064","Total",8748,4457,4291,8625,123,69,340.94,25.7
"2011","Chesterfield 011","E02004065","Total",8437,4080,4357,8340,97,177,333.07,25.3
"2011","Chesterfield 012","E02004066","Total",11731,5732,5999,11515,216,141,471.12,24.9
"2011","Chesterfield 013","E02004067","Total",6410,3142,3268,6410,0,41,152.34,42.1
"2011","Derbyshire Dales 001","E02004068","Total",7566,3708,3858,7500,66,162,9379.11,0.8
"2011","Derbyshire Dales 002","E02004069","Total",6762,3278,3484,6660,102,183,11936.39,0.6
"2011","Derbyshire Dales 003","E02004070","Total",6385,3003,3382,6158,227,115,12709.83,0.5
"2011","Derbyshire Dales 004","E02004071","Total",5118,2467,2651,5096,22,81,2767.83,1.8
"2011","Derbyshire Dales 005","E02004072","Total",8558,4244,4314,8390,168,168,1768.68,4.8
"2011","Derbyshire Dales 006","E02004073","Total",9050,4441,4609,8947,103,142,4892.71,1.8
"2011","Derbyshire Dales 007","E02004074","Total",5813,2910,2903,5796,17,85,1645.58,3.5
"2011","Derbyshire Dales 008","E02004075","Total",7447,3724,3723,7390,57,166,16691.20,0.4
"2011","Derbyshire Dales 009","E02004076","Total",6582,3184,3398,6512,70,98,349.28,18.8
"2011","Derbyshire Dales 010","E02004077","Total",7835,4112,3723,7113,722,145,17104.60,0.5
"2011","Erewash 001","E02004078","Total",7148,3440,3708,7117,31,23,241.67,29.6
"2011","Erewash 003","E02004080","Total",9395,4698,4697,9266,129,36,286.34,32.8
"2011","Erewash 004","E02004081","Total",5716,2787,2929,5660,56,103,2420.43,2.4
"2011","Erewash 005","E02004082","Total",6304,3059,3245,6128,176,81,1796.34,3.5
"2011","Erewash 006","E02004083","Total",7760,3864,3896,7745,15,50,302.10,25.7
"2011","Erewash 007","E02004084","Total",6216,2981,3235,6140,76,25,263.13,23.6
"2011","Erewash 008","E02004085","Total",8688,4199,4489,8572,116,81,1720.72,5.0
"2011","Erewash 009","E02004086","Total",7335,3516,3819,7236,99,92,857.20,8.6
"2011","Erewash 010","E02004087","Total",7818,3814,4004,7776,42,48,167.79,46.6
"2011","Erewash 011","E02004088","Total",7614,3750,3864,7434,180,126,343.02,22.2
"2011","Erewash 012","E02004089","Total",6705,3362,3343,6668,37,31,176.82,37.9
"2011","Erewash 013","E02004090","Total",6140,3018,3122,6082,58,76,1236.73,5.0
"2011","Erewash 014","E02004091","Total",8889,4420,4469,8821,68,76,662.25,13.4
"2011","Erewash 015","E02004092","Total",9556,4672,4884,9556,0,77,299.89,31.9
"2011","Erewash 016","E02006828","Total",6797,3354,3443,6738,59,59,188.50,36.1
"2011","High Peak 001","E02004093","Total",6408,3139,3269,6358,50,63,5014.34,1.3
"2011","High Peak 002","E02004094","Total",7325,3533,3792,7257,68,76,280.40,26.1
"2011","High Peak 003","E02004095","Total",9866,4854,5012,9828,38,100,374.90,26.3
"2011","High Peak 004","E02004096","Total",9491,4681,4810,9408,83,206,6933.03,1.4
"2011","High Peak 005","E02004097","Total",7678,3854,3824,7638,40,124,2512.20,3.1
"2011","High Peak 006","E02004098","Total",7317,3589,3728,7262,55,81,3620.78,2.0
"2011","High Peak 008","E02004100","Total",7610,3766,3844,7525,85,144,3827.24,2.0
"2011","High Peak 010","E02004102","Total",8540,4170,4370,8037,503,162,1126.68,7.6
"2011","High Peak 011","E02004103","Total",7072,3477,3595,7069,3,60,359.26,19.7
"2011","High Peak 012","E02004104","Total",7074,3505,3569,7045,29,121,6376.43,1.1
"2011","High Peak 013","E02006872","Total",12511,6206,6305,12440,71,184,23489.43,0.5
"2011","North East Derbyshire 001","E02004105","Total",9445,4652,4793,9390,55,75,628.49,15.0
"2011","North East Derbyshire 002","E02004106","Total",6986,3442,3544,6986,0,71,1935.22,3.6
"2011","North East Derbyshire 004","E02004108","Total",7538,3636,3902,7438,100,75,1345.80,5.6
"2011","North East Derbyshire 005","E02004109","Total",6742,3298,3444,6702,40,89,4482.53,1.5
"2011","North East Derbyshire 006","E02004110","Total",7464,3661,3803,7464,0,113,359.10,20.8
"2011","North East Derbyshire 007","E02004111","Total",5477,2655,2822,5449,28,48,2460.53,2.2
"2011","North East Derbyshire 008","E02004112","Total",6525,3205,3320,6482,43,133,4370.95,1.5
"2011","North East Derbyshire 009","E02004113","Total",9191,4539,4652,9115,76,50,1237.92,7.4
"2011","North East Derbyshire 010","E02004114","Total",7283,3558,3725,7217,66,119,4909.73,1.5
"2011","North East Derbyshire 011","E02004115","Total",9020,4460,4560,8962,58,76,1035.67,8.7
"2011","North East Derbyshire 012","E02004116","Total",7887,3902,3985,7810,77,57,531.81,14.8
"2011","North East Derbyshire 013","E02004117","Total",7312,3563,3749,7253,59,62,3216.78,2.3
"2011","North East Derbyshire 014","E02006804","Total",8153,3993,4160,7972,181,48,1045.50,7.8
"2011","South Derbyshire 001","E02004118","Total",6815,3335,3480,6523,292,100,7683.22,0.9
"2011","South Derbyshire 002","E02004119","Total",10860,5411,5449,10791,69,151,2526.89,4.3
"2011","South Derbyshire 003","E02004120","Total",7252,3603,3649,7236,16,75,1665.42,4.4
"2011","South Derbyshire 004","E02004121","Total",6666,3315,3351,6634,32,110,4259.67,1.6
"2011","South Derbyshire 005","E02004122","Total",6544,3287,3257,5855,689,142,4991.92,1.3
"2011","South Derbyshire 006","E02004123","Total",6383,3127,3256,6323,60,133,3985.97,1.6
"2011","South Derbyshire 007","E02004124","Total",7614,3730,3884,7607,7,66,320.52,23.8
"2011","South Derbyshire 008","E02004125","Total",8988,4450,4538,8950,38,59,692.99,13.0
"2011","South Derbyshire 009","E02004126","Total",6900,3498,3402,6852,48,64,240.04,28.7
"2011","South Derbyshire 011","E02004128","Total",10255,5054,5201,10093,162,96,6481.11,1.6
"2011","South Derbyshire 012","E02006919","Total",8529,4247,4282,8470,59,58,415.03,20.6
"2011","South Derbyshire 013","E02006920","Total",7805,3906,3899,7799,6,67,549.28,14.2
"2011","Blaby 002","E02005334","Total",5640,2758,2882,5554,86,102,157.48,35.8
"2011","Blaby 003","E02005335","Total",6891,3299,3592,6794,97,114,2342.95,2.9
"2011","Blaby 004","E02005336","Total",7106,3552,3554,7106,0,64,245.43,29.0
"2011","Blaby 005","E02005337","Total",9744,4819,4925,9734,10,96,250.51,38.9
"2011","Blaby 006","E02005338","Total",9853,4805,5048,9755,98,118,1414.98,7.0
"2011","Blaby 007","E02005339","Total",8448,4170,4278,8442,6,123,572.56,14.8
"2011","Blaby 008","E02005340","Total",8844,4560,4284,8289,555,90,598.37,14.8
"2011","Blaby 009","E02005341","Total",6913,3336,3577,6865,48,96,875.60,7.9
"2011","Blaby 010","E02005342","Total",6725,3249,3476,6708,17,100,2157.02,3.1
"2011","Blaby 011","E02005343","Total",6647,3238,3409,6614,33,100,1472.04,4.5
"2011","Blaby 012","E02005344","Total",7461,3671,3790,7411,50,80,2452.95,3.0
"2011","Blaby 013","E02006820","Total",9643,4771,4872,9622,21,118,506.77,19.0
"2011","Charnwood 001","E02005345","Total",6061,3014,3047,6054,7,94,867.19,7.0
"2011","Charnwood 002","E02005346","Total",11278,5843,5435,11013,265,105,771.33,14.6
"2011","Charnwood 003","E02005347","Total",9882,5257,4625,9064,818,129,188.16,52.5
"2011","Charnwood 004","E02005348","Total",5829,2936,2893,5766,63,108,364.23,16.0
"2011","Charnwood 005","E02005349","Total",6986,3420,3566,6906,80,79,911.94,7.7
"2011","Charnwood 006","E02005350","Total",6519,3203,3316,6315,204,89,899.27,7.2
"2011","Charnwood 007","E02005351","Total",10662,6040,4622,6065,4597,230,220.92,48.3
"2011","Charnwood 008","E02005352","Total",6156,3034,3122,6023,133,132,7873.02,0.8
"2011","Charnwood 009","E02005353","Total",9433,4623,4810,9369,64,117,351.15,26.9
"2011","Charnwood 010","E02005354","Total",9088,4491,4597,8755,333,205,956.62,9.5
"2011","Charnwood 011","E02005355","Total",6534,3147,3387,6508,26,102,1130.66,5.8
"2011","Charnwood 012","E02005356","Total",6493,3154,3339,6392,101,120,1108.73,5.9
"2011","Charnwood 013","E02005357","Total",7257,3585,3672,7196,61,83,805.92,9.0
"2011","Charnwood 014","E02005358","Total",10175,4985,5190,10127,48,136,688.61,14.8
"2011","Charnwood 015","E02005359","Total",5884,2838,3046,5827,57,94,3473.57,1.7
"2011","Charnwood 016","E02005360","Total",6342,3168,3174,5984,358,181,4921.24,1.3
"2011","Charnwood 017","E02005361","Total",6561,3174,3387,6490,71,92,515.45,12.7
"2011","Charnwood 018","E02005362","Total",6243,3062,3181,6232,11,63,176.66,35.3
"2011","Charnwood 019","E02005363","Total",7221,3479,3742,7203,18,119,612.92,11.8
"2011","Charnwood 020","E02005364","Total",5300,2555,2745,5300,0,74,104.25,50.8
"2011","Charnwood 021","E02005365","Total",9668,4768,4900,9609,59,104,466.63,20.7
"2011","Charnwood 022","E02005366","Total",6528,3137,3391,6521,7,57,497.21,13.1
"2011","Harborough 002","E02005368","Total",6201,3053,3148,6168,33,218,21832.73,0.3
"2011","Harborough 003","E02005369","Total",9799,4677,5122,9729,70,205,5126.94,1.9
"2011","Harborough 004","E02005370","Total",8940,4477,4463,8907,33,131,999.06,8.9
"2011","Harborough 005","E02005371","Total",10045,4954,5091,9882,163,197,9972.82,1.0
"2011","Harborough 006","E02005372","Total",9416,4752,4664,9330,86,210,14778.14,0.6
"2011","Harborough 007","E02005373","Total",9720,5084,4636,9064,656,186,2338.60,4.2
"2011","Harborough 008","E02005374","Total",6532,3178,3354,6315,217,64,194.10,33.7
"2011","Harborough 009","E02005375","Total",8396,4095,4301,8346,50,116,503.59,16.7
"2011","Harborough 010","E02005376","Total",9353,4647,4706,9320,33,143,1101.70,8.5
"2011","Harborough 011","E02006816","Total",6980,3436,3544,6947,33,156,2330.07,3.0
"2011","Hinckley and Bosworth 001","E02005377","Total",8286,4054,4232,8217,69,108,3271.57,2.5
"2011","Hinckley and Bosworth 002","E02005378","Total",5199,2535,2664,5199,0,67,780.05,6.7
"2011","Hinckley and Bosworth 003","E02005379","Total",6065,2943,3122,6065,0,81,926.27,6.5
"2011","Hinckley and Bosworth 004","E02005380","Total",8373,4124,4249,8312,61,171,9438.23,0.9
"2011","Hinckley and Bosworth 005","E02005381","Total",8009,3925,4084,7917,92,114,4392.38,1.8
"2011","Hinckley and Bosworth 006","E02005382","Total",10047,4949,5098,9952,95,62,820.41,12.2
"2011","Hinckley and Bosworth 007","E02005383","Total",9022,4434,4588,8927,95,71,853.32,10.6
"2011","Hinckley and Bosworth 008","E02005384","Total",6419,3239,3180,6271,148,91,6811.41,0.9
"2011","Hinckley and Bosworth 009","E02005385","Total",5953,2935,3018,5942,11,103,441.82,13.5
"2011","Hinckley and Bosworth 010","E02005386","Total",8375,4226,4149,8228,147,70,179.26,46.7
"2011","Hinckley and Bosworth 011","E02005387","Total",9072,4480,4592,9049,23,65,416.99,21.8
"2011","Hinckley and Bosworth 012","E02005388","Total",5690,2810,2880,5675,15,41,146.33,38.9
"2011","Hinckley and Bosworth 013","E02005389","Total",5706,2733,2973,5666,40,48,337.37,16.9
"2011","Hinckley and Bosworth 014","E02005390","Total",8862,4313,4549,8855,7,130,919.50,9.6
"2011","Melton 001","E02005391","Total",9616,4709,4907,9616,0,188,16314.12,0.6
"2011","Melton 002","E02005392","Total",8906,4344,4562,8850,56,102,833.89,10.7
"2011","Melton 003","E02005393","Total",6996,3381,3615,6939,57,109,9440.51,0.7
"2011","Melton 004","E02005394","Total",9383,4570,4813,9252,131,55,794.48,11.8
"2011","Melton 005","E02005395","Total",8869,4399,4470,8764,105,112,677.82,13.1
"2011","Melton 006","E02005396","Total",6606,3315,3291,6495,111,160,20076.86,0.3
"2011","North West Leicestershire 001","E02005397","Total",8283,4188,4095,8215,68,123,4446.15,1.9
"2011","North West Leicestershire 002","E02005398","Total",6095,2982,3113,6034,61,102,3833.78,1.6
"2011","North West Leicestershire 003","E02005399","Total",6363,3168,3195,6304,59,101,1040.93,6.1
"2011","North West Leicestershire 004","E02005400","Total",5637,2812,2825,5587,50,46,726.86,7.8
"2011","North West Leicestershire 005","E02005401","Total",5712,2810,2902,5684,28,112,5024.93,1.1
"2011","North West Leicestershire 006","E02005402","Total",6167,2976,3191,6033,134,112,982.97,6.3
"2011","North West Leicestershire 007","E02005403","Total",6867,3363,3504,6841,26,84,525.83,13.1
"2011","North West Leicestershire 008","E02005404","Total",7559,3721,3838,7539,20,79,2032.74,3.7
"2011","North West Leicestershire 009","E02005405","Total",6907,3365,3542,6816,91,47,1635.04,4.2
"2011","North West Leicestershire 010","E02005406","Total",7393,3663,3730,7270,123,54,265.98,27.8
"2011","North West Leicestershire 011","E02005407","Total",8676,4309,4367,8676,0,82,1078.24,8.0
"2011","North West Leicestershire 012","E02005408","Total",7461,3824,3637,7413,48,107,4217.64,1.8
"2011","North West Leicestershire 013","E02005409","Total",10348,5154,5194,10285,63,102,2121.76,4.9
"2011","Oadby and Wigston 003","E02005412","Total",8178,3886,4292,8063,115,141,400.80,20.4
"2011","Oadby and Wigston 005","E02005414","Total",7774,3662,4112,7544,230,50,188.49,41.2
"2011","Oadby and Wigston 006","E02005415","Total",7490,3612,3878,7373,117,42,316.07,23.7
"2011","Oadby and Wigston 007","E02005416","Total",8802,4309,4493,8796,6,123,692.28,12.7
"2011","Oadby and Wigston 008","E02006818","Total",8255,4014,4241,8236,19,103,173.88,47.5
"2011","Oadby and Wigston 009","E02006911","Total",15671,7686,7985,13753,1918,446,580.81,27.0
"2011","Boston 001","E02005417","Total",7296,3775,3521,6943,353,86,10436.66,0.7
"2011","Boston 002","E02005418","Total",10021,4843,5178,9997,24,49,292.89,34.2
"2011","Boston 003","E02005419","Total",8131,4051,4080,7978,153,72,321.79,25.3
"2011","Boston 004","E02005420","Total",8229,3900,4329,8187,42,57,245.09,33.6
"2011","Boston 006","E02005422","Total",6085,3021,3064,6085,0,67,12192.21,0.5
"2011","Boston 007","E02005423","Total",9541,4586,4955,9466,75,97,8225.83,1.2
"2011","Boston 008","E02006864","Total",8003,3805,4198,7919,84,134,3466.08,2.3
"2011","Boston 009","E02006865","Total",7331,3555,3776,7161,170,89,973.22,7.5
"2011","East Lindsey 001","E02005424","Total",9904,4846,5058,9778,126,166,14634.48,0.7
"2011","East Lindsey 002","E02005425","Total",6338,3130,3208,6338,0,69,12573.17,0.5
"2011","East Lindsey 003","E02005426","Total",9633,4573,5060,9469,164,120,669.43,14.4
"2011","East Lindsey 004","E02005427","Total",6786,3266,3520,6697,89,104,468.70,14.5
"2011","East Lindsey 005","E02005428","Total",8082,3922,4160,7890,192,64,7355.23,1.1
"2011","East Lindsey 006","E02005429","Total",6515,3089,3426,6385,130,37,1534.29,4.2
"2011","East Lindsey 007","E02005430","Total",6867,3368,3499,6820,47,97,28206.01,0.2
"2011","East Lindsey 008","E02005431","Total",8384,4090,4294,8261,123,95,18960.11,0.4
"2011","East Lindsey 009","E02005432","Total",7515,3703,3812,7418,97,128,38197.50,0.2
"2011","East Lindsey 010","E02005433","Total",7066,3476,3590,6613,453,27,4095.13,1.7
"2011","East Lindsey 011","E02005434","Total",7073,3409,3664,6984,89,65,1134.47,6.2
"2011","East Lindsey 012","E02005435","Total",7279,3443,3836,7096,183,50,792.38,9.2
"2011","East Lindsey 013","E02005436","Total",7676,3710,3966,7515,161,79,6989.64,1.1
"2011","East Lindsey 014","E02005437","Total",5861,2916,2945,5529,332,46,233.65,25.1
"2011","East Lindsey 015","E02005438","Total",6439,2992,3447,6387,52,59,609.48,10.6
"2011","East Lindsey 016","E02005439","Total",11241,5713,5528,10541,700,144,5436.45,2.1
"2011","East Lindsey 017","E02005440","Total",5363,2638,2725,5322,41,49,11183.84,0.5
"2011","East Lindsey 018","E02005441","Total",8379,4143,4236,8357,22,131,22951.62,0.4
"2011","Lincoln 001","E02005442","Total",5736,2724,3012,5665,71,35,117.31,48.9
"2011","Lincoln 002","E02005443","Total",6811,3246,3565,6714,97,54,181.22,37.6
"2011","Lincoln 003","E02005444","Total",11954,6032,5922,11113,841,171,670.01,17.8
"2011","Lincoln 004","E02005445","Total",11600,5823,5777,11186,414,99,404.77,28.7
"2011","Lincoln 005","E02005446","Total",8473,4009,4464,6039,2434,148,186.18,45.5
"2011","Lincoln 006","E02005447","Total",6759,3412,3347,6629,130,46,341.62,19.8
"2011","Lincoln 007","E02005448","Total",7192,3468,3724,7192,0,51,189.81,37.9
"2011","Lincoln 008","E02005449","Total",7918,3930,3988,6563,1355,96,580.53,13.6
"2011","Lincoln 009","E02005450","Total",8486,4112,4374,8339,147,71,381.45,22.2
"2011","Lincoln 010","E02005451","Total",7639,3740,3899,7553,86,49,173.45,44.0
"2011","Lincoln 011","E02005452","Total",10973,5277,5696,10887,86,137,342.45,32.0
"2011","North Kesteven 001","E02005453","Total",10568,5159,5409,10543,25,155,1828.87,5.8
"2011","North Kesteven 003","E02005455","Total",12280,5992,6288,12098,182,151,12667.08,1.0
"2011","North Kesteven 004","E02005456","Total",9781,4821,4960,9283,498,120,2611.42,3.7
"2011","North Kesteven 005","E02005457","Total",8344,4036,4308,8207,137,141,10592.50,0.8
"2011","North Kesteven 006","E02005458","Total",6527,3144,3383,6405,122,124,11858.32,0.6
"2011","North Kesteven 007","E02005459","Total",8005,3895,4110,7891,114,90,13939.13,0.6
"2011","North Kesteven 008","E02005460","Total",6247,3208,3039,5915,332,105,6238.60,1.0
"2011","North Kesteven 009","E02005461","Total",6261,3016,3245,6221,40,105,14693.92,0.4
"2011","North Kesteven 010","E02005462","Total",9064,4374,4690,8948,116,98,896.03,10.1
"2011","North Kesteven 011","E02005463","Total",8607,4175,4432,8594,13,157,942.12,9.1
"2011","North Kesteven 012","E02005464","Total",8198,4036,4162,8105,93,102,15048.27,0.5
"2011","North Kesteven 013","E02006866","Total",6473,3143,3330,6393,80,49,371.51,17.4
"2011","North Kesteven 014","E02006867","Total",7411,3604,3807,7377,34,57,556.51,13.3
"2011","South Holland 001","E02005465","Total",8440,4126,4314,8344,96,83,9117.17,0.9
"2011","South Holland 002","E02005466","Total",6507,3194,3313,6423,84,61,12561.53,0.5
"2011","South Holland 003","E02005467","Total",7110,3428,3682,7050,60,57,403.71,17.6
"2011","South Holland 004","E02005468","Total",7492,3703,3789,7467,25,84,10376.31,0.7
"2011","South Holland 005","E02005469","Total",7416,3666,3750,7384,32,87,12254.51,0.6
"2011","South Holland 006","E02005470","Total",10379,5067,5312,10285,94,131,482.09,21.5
"2011","South Holland 007","E02005471","Total",9080,4409,4671,9029,51,86,1699.89,5.3
"2011","South Holland 008","E02005472","Total",9828,4778,5050,9691,137,67,8973.17,1.1
"2011","South Holland 009","E02005473","Total",9263,4479,4784,9106,157,89,991.81,9.3
"2011","South Holland 010","E02005474","Total",6546,3217,3329,6445,101,73,10129.67,0.6
"2011","South Holland 011","E02005475","Total",6209,3052,3157,6185,24,71,7248.45,0.9
"2011","South Kesteven 001","E02005476","Total",7239,3528,3711,7209,30,145,12590.07,0.6
"2011","South Kesteven 002","E02005477","Total",8844,4289,4555,8811,33,166,10221.63,0.9
"2011","South Kesteven 003","E02005478","Total",9908,4684,5224,9773,135,134,301.94,32.8
"2011","South Kesteven 004","E02005479","Total",8277,4012,4265,8097,180,143,364.74,22.7
"2011","South Kesteven 005","E02005480","Total",7332,3538,3794,7331,1,50,224.56,32.7
"2011","South Kesteven 006","E02005481","Total",10963,5378,5585,10838,125,113,680.81,16.1
"2011","South Kesteven 007","E02005482","Total",9774,4816,4958,9752,22,210,20393.68,0.5
"2011","South Kesteven 008","E02005483","Total",7829,3788,4041,7753,76,140,13628.21,0.6
"2011","South Kesteven 009","E02005484","Total",6952,3443,3509,6951,1,104,14711.62,0.5
"2011","South Kesteven 010","E02005485","Total",6055,2920,3135,5944,111,121,825.54,7.3
"2011","South Kesteven 011","E02005486","Total",8401,3995,4406,8306,95,139,3261.95,2.6
"2011","South Kesteven 012","E02005487","Total",9199,4529,4670,9097,102,258,13381.43,0.7
"2011","South Kesteven 013","E02005488","Total",6263,3028,3235,6198,65,144,1271.56,4.9
"2011","South Kesteven 014","E02005489","Total",7051,3371,3680,7029,22,117,1605.31,4.4
"2011","South Kesteven 015","E02005490","Total",9132,4334,4798,9047,85,121,280.75,32.5
"2011","South Kesteven 016","E02005491","Total",10569,5003,5566,10357,212,205,515.65,20.5
"2011","West Lindsey 001","E02005492","Total",9425,4635,4790,9332,93,193,22627.17,0.4
"2011","West Lindsey 002","E02005493","Total",9304,4529,4775,9113,191,122,10332.02,0.9
"2011","West Lindsey 003","E02005494","Total",9452,4631,4821,9158,294,146,20592.02,0.5
"2011","West Lindsey 004","E02005495","Total",9645,4745,4900,9570,75,74,590.15,16.3
"2011","West Lindsey 005","E02005496","Total",6456,3233,3223,6375,81,95,19724.73,0.3
"2011","West Lindsey 006","E02005497","Total",7031,3354,3677,6924,107,36,293.81,23.9
"2011","West Lindsey 007","E02005498","Total",7152,3482,3670,7090,62,114,10496.42,0.7
"2011","West Lindsey 008","E02005499","Total",8068,3894,4174,8021,47,155,8915.26,0.9
"2011","West Lindsey 009","E02005500","Total",6795,3350,3445,6695,100,104,7888.93,0.9
"2011","West Lindsey 010","E02005501","Total",7358,3492,3866,7210,148,137,3627.70,2.0
"2011","West Lindsey 011","E02005502","Total",8564,4146,4418,8362,202,81,10483.52,0.8
"2011","Corby 001","E02005612","Total",6676,3250,3426,6633,43,91,3943.18,1.7
"2011","Corby 002","E02005613","Total",8833,4357,4476,8777,56,60,210.42,42.0
"2011","Corby 003","E02005614","Total",6706,3372,3334,6620,86,57,2670.91,2.5
"2011","Corby 004","E02005615","Total",8507,4118,4389,8496,11,93,227.65,37.4
"2011","Corby 005","E02005616","Total",5299,2632,2667,5286,13,36,200.52,26.4
"2011","Corby 006","E02005617","Total",9738,4746,4992,9734,4,70,245.83,39.6
"2011","Corby 008","E02006862","Total",6112,3014,3098,6110,2,85,290.58,21.0
"2011","Corby 009","E02006863","Total",9384,4658,4726,9334,50,71,239.19,39.2
"2011","Daventry 001","E02005619","Total",5844,2918,2926,5720,124,174,15308.66,0.4
"2011","Daventry 002","E02005620","Total",7980,3962,4018,7803,177,190,7422.97,1.1
"2011","Daventry 003","E02005621","Total",7958,4480,3478,6832,1126,147,7543.02,1.1
"2011","Daventry 004","E02005622","Total",8785,4310,4475,8746,39,251,10825.97,0.8
"2011","Daventry 005","E02005623","Total",8025,3861,4164,7799,226,155,5582.73,1.4
"2011","Daventry 006","E02005624","Total",9242,4578,4664,9242,0,99,621.00,14.9
"2011","Daventry 007","E02005625","Total",9122,4493,4629,8979,143,69,267.84,34.1
"2011","Daventry 008","E02005626","Total",6662,3277,3385,6624,38,59,580.63,11.5
"2011","Daventry 009","E02005627","Total",6711,3291,3420,6711,0,111,7247.71,0.9
"2011","Daventry 010","E02005628","Total",7514,3729,3785,7430,84,182,10858.48,0.7
"2011","East Northamptonshire 001","E02005629","Total",5703,2840,2863,5652,51,128,14753.02,0.4
"2011","East Northamptonshire 002","E02005630","Total",9917,4957,4960,8915,1002,311,13793.98,0.7
"2011","East Northamptonshire 003","E02005631","Total",10006,4983,5023,9977,29,169,11027.46,0.9
"2011","East Northamptonshire 004","E02005632","Total",6042,3010,3032,5929,113,110,4806.05,1.3
"2011","East Northamptonshire 005","E02005633","Total",8641,4303,4338,8528,113,98,1808.32,4.8
"2011","East Northamptonshire 006","E02005634","Total",8535,4251,4284,8410,125,73,1178.61,7.2
"2011","East Northamptonshire 007","E02005635","Total",8649,4272,4377,8578,71,93,2064.66,4.2
"2011","East Northamptonshire 008","E02005636","Total",11136,5414,5722,10987,149,98,609.05,18.3
"2011","East Northamptonshire 009","E02005637","Total",8302,4127,4175,8159,143,58,355.04,23.4
"2011","East Northamptonshire 010","E02005638","Total",9834,4901,4933,9775,59,102,582.61,16.9
"2011","Kettering 001","E02005639","Total",5276,2586,2690,5195,81,107,12785.08,0.4
"2011","Kettering 002","E02005640","Total",10697,5251,5446,10549,148,113,967.53,11.1
"2011","Kettering 003","E02005641","Total",7694,3752,3942,7688,6,83,1372.17,5.6
"2011","Kettering 004","E02005642","Total",8266,4036,4230,8131,135,136,175.95,47.0
"2011","Kettering 005","E02005643","Total",8047,3975,4072,8047,0,47,220.33,36.5
"2011","Kettering 006","E02005644","Total",8251,4242,4009,8112,139,51,103.80,79.5
"2011","Kettering 007","E02005645","Total",10992,5381,5611,10722,270,132,471.06,23.3
"2011","Kettering 008","E02005646","Total",6423,3100,3323,6423,0,75,287.98,22.3
"2011","Kettering 009","E02005647","Total",7032,3466,3566,6950,82,78,331.86,21.2
"2011","Kettering 010","E02005648","Total",7215,3570,3645,7167,48,158,339.02,21.3
"2011","Kettering 011","E02005649","Total",13582,6537,7045,13537,45,193,6294.46,2.2
"2011","Northampton 001","E02005650","Total",6852,3261,3591,5731,1121,113,174.92,39.2
"2011","Northampton 002","E02005651","Total",6277,3024,3253,6213,64,66,340.15,18.5
"2011","Northampton 003","E02005652","Total",5965,2902,3063,5879,86,63,150.15,39.7
"2011","Northampton 004","E02005653","Total",8119,3961,4158,8025,94,69,224.98,36.1
"2011","Northampton 005","E02005654","Total",8223,3900,4323,8223,0,82,172.69,47.6
"2011","Northampton 006","E02005655","Total",5811,2764,3047,5769,42,70,180.75,32.1
"2011","Northampton 007","E02005656","Total",5901,2854,3047,5901,0,55,147.87,39.9
"2011","Northampton 008","E02005657","Total",6093,2994,3099,6082,11,60,220.32,27.7
"2011","Northampton 009","E02005658","Total",6286,2992,3294,6273,13,45,126.36,49.7
"2011","Northampton 010","E02005659","Total",5063,2441,2622,5014,49,53,119.29,42.4
"2011","Northampton 011","E02005660","Total",5660,2698,2962,5613,47,61,433.47,13.1
"2011","Northampton 012","E02005661","Total",6481,3192,3289,6447,34,60,108.18,59.9
"2011","Northampton 013","E02005662","Total",6732,3308,3424,6568,164,83,126.87,53.1
"2011","Northampton 014","E02005663","Total",5448,2656,2792,5446,2,58,100.02,54.5
"2011","Northampton 015","E02005664","Total",6007,2941,3066,5526,481,69,149.34,40.2
"2011","Northampton 016","E02005665","Total",7365,3596,3769,7358,7,88,230.43,32.0
"2011","Northampton 017","E02005666","Total",8173,3934,4239,8173,0,39,276.70,29.5
"2011","Northampton 018","E02005667","Total",6029,2901,3128,5927,102,60,335.81,18.0
"2011","Northampton 019","E02005668","Total",6108,2957,3151,6070,38,57,174.60,35.0
"2011","Northampton 020","E02005669","Total",5693,2825,2868,5640,53,150,250.24,22.8
"2011","Northampton 021","E02005670","Total",8177,4347,3830,7938,239,29,214.58,38.1
"2011","Northampton 022","E02005671","Total",7285,3707,3578,7230,55,74,93.52,77.9
"2011","Northampton 023","E02005672","Total",7327,3859,3468,7326,1,51,66.80,109.7
"2011","Northampton 024","E02005673","Total",7166,3565,3601,6990,176,33,238.11,30.1
"2011","Northampton 025","E02005674","Total",7051,3675,3376,6497,554,64,264.14,26.7
"2011","Northampton 026","E02005675","Total",5733,2674,3059,5727,6,46,212.60,27.0
"2011","Northampton 027","E02005676","Total",5913,2894,3019,5898,15,38,192.73,30.7
"2011","Northampton 028","E02005677","Total",8053,4036,4017,8044,9,77,1201.32,6.7
"2011","Northampton 029","E02005678","Total",9717,4756,4961,9673,44,129,941.74,10.3
"2011","Northampton 030","E02005679","Total",8828,4367,4461,8822,6,140,308.61,28.6
"2011","Northampton 031","E02005680","Total",8533,4187,4346,8440,93,134,298.88,28.5
"2011","South Northamptonshire 001","E02005681","Total",8128,3954,4174,8086,42,145,4271.77,1.9
"2011","South Northamptonshire 002","E02005682","Total",6358,3113,3245,6354,4,133,8353.26,0.8
"2011","South Northamptonshire 003","E02005683","Total",13255,6545,6710,13084,171,209,5733.15,2.3
"2011","South Northamptonshire 004","E02005684","Total",7984,3988,3996,7939,45,234,8957.68,0.9
"2011","South Northamptonshire 005","E02005685","Total",8066,3986,4080,8034,32,128,2857.09,2.8
"2011","South Northamptonshire 006","E02005686","Total",7461,3639,3822,7350,111,167,8659.17,0.9
"2011","South Northamptonshire 007","E02005687","Total",5920,2939,2981,5861,59,151,9581.59,0.6
"2011","South Northamptonshire 008","E02005688","Total",8671,4336,4335,8667,4,147,5276.22,1.6
"2011","South Northamptonshire 009","E02005689","Total",7641,3773,3868,7606,35,155,472.29,16.2
"2011","South Northamptonshire 010","E02005690","Total",5377,2703,2674,5266,111,76,215.38,25.0
"2011","South Northamptonshire 011","E02005691","Total",6328,3122,3206,6250,78,166,9024.25,0.7
"2011","Wellingborough 001","E02005692","Total",6572,3271,3301,6565,7,83,4421.95,1.5
"2011","Wellingborough 002","E02005693","Total",8272,4020,4252,8272,0,88,385.94,21.4
"2011","Wellingborough 003","E02005694","Total",7647,3781,3866,7630,17,127,374.85,20.4
"2011","Wellingborough 004","E02005695","Total",7321,3700,3621,7241,80,77,562.16,13.0
"2011","Wellingborough 005","E02005696","Total",5818,2754,3064,5773,45,34,329.60,17.7
"2011","Wellingborough 006","E02005697","Total",6047,3005,3042,5904,143,76,177.08,34.1
"2011","Wellingborough 007","E02005698","Total",5743,2723,3020,5681,62,53,118.65,48.4
"2011","Wellingborough 008","E02005699","Total",8239,4121,4118,7947,292,72,317.72,25.9
"2011","Wellingborough 009","E02005700","Total",8865,4342,4523,8839,26,144,4448.81,2.0
"2011","Wellingborough 010","E02005701","Total",10832,5359,5473,10731,101,128,5167.18,2.1
"2011","Ashfield 001","E02005819","Total",6146,3016,3130,6141,5,37,1580.20,3.9
"2011","Ashfield 002","E02005820","Total",5728,2845,2883,5695,33,35,137.58,41.6
"2011","Ashfield 003","E02005821","Total",6388,3133,3255,6343,45,40,496.22,12.9
"2011","Ashfield 004","E02005822","Total",9531,4749,4782,9422,109,53,370.58,25.7
"2011","Ashfield 005","E02005823","Total",7518,3561,3957,7243,275,32,203.89,36.9
"2011","Ashfield 006","E02005824","Total",9727,4838,4889,9684,43,70,330.73,29.4
"2011","Ashfield 007","E02005825","Total",8012,3922,4090,7847,165,62,1472.44,5.4
"2011","Ashfield 008","E02005826","Total",6072,2982,3090,5972,100,34,138.83,43.7
"2011","Ashfield 009","E02005827","Total",8303,4107,4196,8268,35,83,1354.01,6.1
"2011","Ashfield 010","E02005828","Total",7109,3500,3609,7072,37,38,1706.28,4.2
"2011","Ashfield 011","E02005829","Total",6753,3329,3424,6665,88,29,590.36,11.4
"2011","Ashfield 012","E02005830","Total",6111,2987,3124,6092,19,49,959.14,6.4
"2011","Ashfield 013","E02005831","Total",8570,4176,4394,8450,120,77,496.54,17.3
"2011","Ashfield 014","E02005832","Total",8924,4320,4604,8829,95,42,164.32,54.3
"2011","Ashfield 015","E02005833","Total",7427,3654,3773,7392,35,66,531.80,14.0
"2011","Ashfield 016","E02005834","Total",7178,3546,3632,7098,80,52,422.77,17.0
"2011","Bassetlaw 001","E02005835","Total",10180,5002,5178,10035,145,82,3445.03,3.0
"2011","Bassetlaw 002","E02005836","Total",8933,4431,4502,8892,41,148,13017.91,0.7
"2011","Bassetlaw 003","E02005837","Total",7809,4384,3425,6593,1216,170,13351.19,0.6
"2011","Bassetlaw 004","E02005838","Total",8095,3909,4186,8054,41,59,3525.29,2.3
"2011","Bassetlaw 005","E02005839","Total",6162,2975,3187,6083,79,69,386.67,15.9
"2011","Bassetlaw 006","E02005840","Total",9050,4499,4551,8974,76,107,371.36,24.4
"2011","Bassetlaw 008","E02005842","Total",8622,4212,4410,8470,152,139,946.28,9.1
"2011","Bassetlaw 009","E02005843","Total",6403,3177,3226,6328,75,63,857.97,7.5
"2011","Bassetlaw 010","E02005844","Total",7566,3730,3836,7516,50,68,549.91,13.8
"2011","Bassetlaw 012","E02005846","Total",6491,3156,3335,6347,144,20,167.94,38.7
"2011","Bassetlaw 013","E02005847","Total",6634,3220,3414,6567,67,70,451.73,14.7
"2011","Bassetlaw 014","E02005848","Total",6799,3366,3433,6591,208,73,10616.76,0.6
"2011","Bassetlaw 015","E02005849","Total",9055,4649,4406,8582,473,150,15829.02,0.6
"2011","Bassetlaw 016","E02006903","Total",11064,5314,5750,10947,117,92,270.02,41.0
"2011","Broxtowe 001","E02005850","Total",6892,3387,3505,6776,116,61,1197.24,5.8
"2011","Broxtowe 002","E02005851","Total",5927,2908,3019,5863,64,26,195.31,30.3
"2011","Broxtowe 003","E02005852","Total",7930,3935,3995,7907,23,49,895.71,8.9
"2011","Broxtowe 004","E02005853","Total",8976,4388,4588,8959,17,124,876.94,10.2
"2011","Broxtowe 007","E02005856","Total",7270,3588,3682,7246,24,141,458.67,15.9
"2011","Broxtowe 008","E02005857","Total",6238,3050,3188,6238,0,29,174.89,35.7
"2011","Broxtowe 009","E02005858","Total",7450,3719,3731,7449,1,91,144.42,51.6
"2011","Broxtowe 010","E02005859","Total",9003,4435,4568,8975,28,100,253.19,35.6
"2011","Broxtowe 011","E02005860","Total",8339,4197,4142,8179,160,79,172.30,48.4
"2011","Broxtowe 012","E02005861","Total",5516,2786,2730,5424,92,38,252.36,21.9
"2011","Broxtowe 013","E02005862","Total",7823,3843,3980,7668,155,112,242.49,32.3
"2011","Broxtowe 014","E02005863","Total",7369,3615,3754,7181,188,113,531.10,13.9
"2011","Broxtowe 015","E02005864","Total",8238,4011,4227,8200,38,123,385.84,21.4
"2011","Broxtowe 016","E02006906","Total",12516,6256,6260,12505,11,149,2229.38,5.6
"2011","Gedling 001","E02005865","Total",7929,3892,4037,7906,23,150,3646.59,2.2
"2011","Gedling 002","E02005866","Total",8948,4340,4608,8882,66,121,2705.23,3.3
"2011","Gedling 004","E02005868","Total",6451,3100,3351,6425,26,73,224.91,28.7
"2011","Gedling 005","E02005869","Total",5837,2750,3087,5790,47,38,182.89,31.9
"2011","Gedling 006","E02005870","Total",6593,3185,3408,6510,83,26,125.97,52.3
"2011","Gedling 007","E02005871","Total",7132,3443,3689,7117,15,89,206.14,34.6
"2011","Gedling 008","E02005872","Total",5777,2802,2975,5701,76,73,2005.64,2.9
"2011","Gedling 009","E02005873","Total",10034,4882,5152,9942,92,183,237.44,42.3
"2011","Gedling 010","E02005874","Total",8384,4139,4245,8353,31,82,228.47,36.7
"2011","Gedling 011","E02005875","Total",7209,3512,3697,7172,37,57,423.18,17.0
"2011","Gedling 012","E02005876","Total",9055,4457,4598,8869,186,88,247.20,36.6
"2011","Gedling 013","E02005877","Total",7365,3680,3685,7327,38,50,137.94,53.4
"2011","Gedling 014","E02005878","Total",9548,4729,4819,9548,0,69,195.68,48.8
"2011","Gedling 015","E02005879","Total",7398,3595,3803,7398,0,35,325.48,22.7
"2011","Gedling 016","E02006835","Total",5883,2842,3041,5819,64,45,1104.87,5.3
"2011","Mansfield 001","E02005880","Total",6237,3071,3166,6235,2,34,1813.10,3.4
"2011","Mansfield 002","E02005881","Total",5762,2808,2954,5669,93,45,1069.26,5.4
"2011","Mansfield 003","E02005882","Total",7891,3893,3998,7883,8,102,392.60,20.1
"2011","Mansfield 004","E02005883","Total",7718,3821,3897,7683,35,41,549.74,14.0
"2011","Mansfield 005","E02005884","Total",6124,3033,3091,6055,69,67,312.88,19.6
"2011","Mansfield 006","E02005885","Total",8282,4011,4271,8206,76,52,692.27,12.0
"2011","Mansfield 007","E02005886","Total",10348,5002,5346,10278,70,108,459.83,22.5
"2011","Mansfield 008","E02005887","Total",9110,4581,4529,8802,308,55,273.43,33.3
"2011","Mansfield 009","E02005888","Total",8171,4009,4162,8037,134,50,215.22,38.0
"2011","Mansfield 010","E02005889","Total",10174,4928,5246,10174,0,72,278.91,36.5
"2011","Mansfield 011","E02005890","Total",6703,3334,3369,6694,9,66,157.78,42.5
"2011","Mansfield 012","E02005891","Total",6323,3149,3174,6205,118,54,761.64,8.3
"2011","Mansfield 013","E02005892","Total",11623,5668,5955,11566,57,161,694.99,16.7
"2011","Newark and Sherwood 001","E02005893","Total",10023,4920,5103,9906,117,82,3479.70,2.9
"2011","Newark and Sherwood 002","E02005894","Total",9853,4786,5067,9706,147,85,3393.47,2.9
"2011","Newark and Sherwood 003","E02005895","Total",7986,3946,4040,7958,28,177,15879.04,0.5
"2011","Newark and Sherwood 004","E02005896","Total",7342,3612,3730,7228,114,108,10241.97,0.7
"2011","Newark and Sherwood 005","E02005897","Total",8926,4423,4503,8812,114,159,10590.67,0.8
"2011","Newark and Sherwood 006","E02005898","Total",10772,5262,5510,10659,113,77,2448.23,4.4
"2011","Newark and Sherwood 007","E02005899","Total",10647,5365,5282,10562,85,84,743.00,14.3
"2011","Newark and Sherwood 008","E02005900","Total",7297,3418,3879,6932,365,190,2396.14,3.0
"2011","Newark and Sherwood 009","E02005901","Total",8872,4320,4552,8775,97,101,368.55,24.1
"2011","Newark and Sherwood 010","E02005902","Total",8181,3895,4286,8123,58,60,250.40,32.7
"2011","Newark and Sherwood 011","E02005903","Total",9757,4735,5022,9757,0,89,676.83,14.4
"2011","Newark and Sherwood 012","E02005904","Total",8283,4090,4193,8158,125,160,9540.29,0.9
"2011","Newark and Sherwood 013","E02005905","Total",6878,3784,3094,5950,928,142,5123.56,1.3
"2011","Rushcliffe 001","E02005906","Total",7035,3849,3186,6161,874,135,8603.60,0.8
"2011","Rushcliffe 002","E02005907","Total",9131,4418,4713,9100,31,130,1387.68,6.6
"2011","Rushcliffe 003","E02005908","Total",8878,4269,4609,8751,127,148,2199.10,4.0
"2011","Rushcliffe 004","E02005909","Total",8192,4120,4072,8152,40,155,172.64,47.5
"2011","Rushcliffe 005","E02005910","Total",8991,4526,4465,8856,135,145,164.05,54.8
"2011","Rushcliffe 006","E02005911","Total",8573,4178,4395,8523,50,165,1014.19,8.5
"2011","Rushcliffe 007","E02005912","Total",8846,4283,4563,8790,56,204,371.19,23.8
"2011","Rushcliffe 008","E02005913","Total",6828,3352,3476,6801,27,172,403.91,16.9
"2011","Rushcliffe 009","E02005914","Total",7203,3502,3701,7084,119,62,1477.23,4.9
"2011","Rushcliffe 010","E02005915","Total",5705,2843,2862,5658,47,112,8621.87,0.7
"2011","Rushcliffe 011","E02005916","Total",7216,3495,3721,7095,121,130,1154.59,6.2
"2011","Rushcliffe 012","E02005917","Total",5741,2865,2876,5679,62,124,5079.41,1.1
"2011","Rushcliffe 013","E02005918","Total",5096,2451,2645,5096,0,65,564.18,9.0
"2011","Rushcliffe 014","E02005919","Total",6379,3029,3350,5800,579,95,4550.42,1.4
"2011","Rushcliffe 015","E02005920","Total",7315,3523,3792,7258,57,155,5159.58,1.4
"2011","Herefordshire 001","E02002905","Total",6043,2986,3057,6022,21,189,22876.60,0.3
"2011","Herefordshire 002","E02002906","Total",5775,2792,2983,5707,68,44,701.22,8.2
"2011","Herefordshire 003","E02002907","Total",5916,2903,3013,5847,69,44,2832.82,2.1
"2011","Herefordshire 004","E02002908","Total",8557,4235,4322,8449,108,171,23046.87,0.4
"2011","Herefordshire 005","E02002909","Total",10349,5115,5234,10122,227,200,21344.98,0.5
"2011","Herefordshire 006","E02002910","Total",7875,3851,4024,7720,155,139,21005.30,0.4
"2011","Herefordshire 007","E02002911","Total",9323,4593,4730,9142,181,190,14484.37,0.6
"2011","Herefordshire 008","E02002912","Total",7144,3598,3546,6917,227,144,5349.51,1.3
"2011","Herefordshire 009","E02002913","Total",5600,2716,2884,5412,188,153,7868.33,0.7
"2011","Herefordshire 010","E02002914","Total",8929,4432,4497,8903,26,100,563.21,15.9
"2011","Herefordshire 011","E02002915","Total",6715,3224,3491,6504,211,131,1437.77,4.7
"2011","Herefordshire 012","E02002916","Total",9663,4905,4758,9413,250,91,319.99,30.2
"2011","Herefordshire 013","E02002917","Total",6900,3438,3462,6844,56,88,269.19,25.6
"2011","Herefordshire 014","E02002918","Total",5963,2852,3111,5862,101,148,196.84,30.3
"2011","Herefordshire 015","E02002919","Total",9312,4621,4691,9259,53,78,297.73,31.3
"2011","Herefordshire 016","E02002920","Total",6524,3259,3265,6493,31,88,3683.59,1.8
"2011","Herefordshire 017","E02002921","Total",7757,3743,4014,7757,0,42,164.36,47.2
"2011","Herefordshire 018","E02002922","Total",6247,3098,3149,6123,124,178,15245.83,0.4
"2011","Herefordshire 019","E02002923","Total",9636,4644,4992,9498,138,110,4606.48,2.1
"2011","Herefordshire 020","E02002924","Total",6073,3011,3062,6047,26,142,27608.42,0.2
"2011","Herefordshire 021","E02002925","Total",10952,5459,5493,10824,128,212,22554.55,0.5
"2011","Herefordshire 022","E02002926","Total",10582,5068,5514,10399,183,148,894.60,11.8
"2011","Herefordshire 023","E02002927","Total",11642,5759,5883,11331,311,250,20620.68,0.6
"2011","Shropshire 025","E02006008","Total",7498,3711,3787,7456,42,116,5948.16,1.3
"2011","Shropshire 027","E02006009","Total",7124,3783,3341,6420,704,103,4600.47,1.5
"2011","Shropshire 029","E02006010","Total",11150,5435,5715,11044,106,178,15391.29,0.7
"2011","Shropshire 031","E02006011","Total",5941,2921,3020,5896,45,95,483.65,12.3
"2011","Shropshire 033","E02006012","Total",6138,3006,3132,6010,128,99,585.18,10.5
"2011","Shropshire 034","E02006013","Total",7743,3845,3898,7607,136,170,16215.51,0.5
"2011","Shropshire 035","E02006014","Total",9211,4618,4593,9022,189,131,20092.74,0.5
"2011","Shropshire 001","E02006015","Total",9871,4870,5001,9718,153,103,2381.42,4.1
"2011","Shropshire 002","E02006016","Total",7503,3735,3768,7398,105,142,16039.23,0.5
"2011","Shropshire 004","E02006017","Total",7463,3693,3770,7174,289,134,10621.31,0.7
"2011","Shropshire 005","E02006018","Total",11773,5750,6023,11692,81,117,461.38,25.5
"2011","Shropshire 008","E02006019","Total",5870,2805,3065,5731,139,76,366.83,16.0
"2011","Shropshire 009","E02006020","Total",7108,3922,3186,6288,820,120,11048.77,0.6
"2011","Shropshire 010","E02006021","Total",7942,3954,3988,7707,235,187,16284.96,0.5
"2011","Shropshire 013","E02006022","Total",5973,3068,2905,5614,359,105,10712.80,0.6
"2011","Shropshire 003","E02006023","Total",9722,4702,5020,9106,616,125,5435.84,1.8
"2011","Shropshire 006","E02006024","Total",9575,4549,5026,9526,49,84,398.55,24.0
"2011","Shropshire 007","E02006025","Total",9168,4548,4620,8899,269,129,707.98,12.9
"2011","Shropshire 011","E02006026","Total",6992,3462,3530,6809,183,122,10582.68,0.7
"2011","Shropshire 012","E02006027","Total",5308,2642,2666,5264,44,82,8482.73,0.6
"2011","Shropshire 014","E02006028","Total",9174,4467,4707,8967,207,172,17829.88,0.5
"2011","Shropshire 015","E02006029","Total",8240,4028,4212,8233,7,44,431.43,19.1
"2011","Shropshire 016","E02006030","Total",7142,3551,3591,7135,7,50,403.25,17.7
"2011","Shropshire 017","E02006031","Total",7381,3615,3766,7211,170,66,207.90,35.5
"2011","Shropshire 018","E02006032","Total",9022,4358,4664,8957,65,102,308.64,29.2
"2011","Shropshire 019","E02006033","Total",8036,4219,3817,7502,534,170,311.30,25.8
"2011","Shropshire 020","E02006034","Total",8520,4138,4382,8330,190,163,510.70,16.7
"2011","Shropshire 021","E02006035","Total",5710,2776,2934,5648,62,102,353.90,16.1
"2011","Shropshire 022","E02006036","Total",6107,2971,3136,6051,56,100,301.92,20.2
"2011","Shropshire 023","E02006037","Total",10093,5056,5037,9398,695,262,435.14,23.2
"2011","Shropshire 024","E02006038","Total",7612,3771,3841,7529,83,161,7366.71,1.0
"2011","Shropshire 026","E02006039","Total",7839,3897,3942,7691,148,171,7847.13,1.0
"2011","Shropshire 028","E02006040","Total",7506,3700,3806,7112,394,168,23854.66,0.3
"2011","Shropshire 030","E02006041","Total",5872,2954,2918,5738,134,102,22399.70,0.3
"2011","Shropshire 032","E02006042","Total",5878,2818,3060,5743,135,106,8479.09,0.7
"2011","Shropshire 036","E02006043","Total",6876,3444,3432,6819,57,136,24325.33,0.3
"2011","Shropshire 037","E02006044","Total",6242,3122,3120,6141,101,127,34145.96,0.2
"2011","Shropshire 038","E02006045","Total",10939,5290,5649,10798,141,135,1329.49,8.2
"2011","Shropshire 039","E02006046","Total",8867,4412,4455,8799,68,150,12046.71,0.7
"2011","Stoke-on-Trent 001","E02002951","Total",7714,3785,3929,7633,81,57,409.53,18.8
"2011","Stoke-on-Trent 002","E02002952","Total",6829,3302,3527,6694,135,30,419.10,16.3
"2011","Stoke-on-Trent 003","E02002953","Total",7350,3501,3849,7338,12,22,171.41,42.9
"2011","Stoke-on-Trent 004","E02002954","Total",8258,4025,4233,8236,22,43,560.97,14.7
"2011","Stoke-on-Trent 005","E02002955","Total",7046,3449,3597,7019,27,29,247.22,28.5
"2011","Stoke-on-Trent 006","E02002956","Total",9277,4579,4698,9171,106,52,225.67,41.1
"2011","Stoke-on-Trent 007","E02002957","Total",9750,4787,4963,9697,53,95,365.50,26.7
"2011","Stoke-on-Trent 008","E02002958","Total",7977,3875,4102,7955,22,52,191.48,41.7
"2011","Stoke-on-Trent 009","E02002959","Total",8436,4330,4106,8209,227,48,298.20,28.3
"2011","Stoke-on-Trent 010","E02002960","Total",5900,2976,2924,5898,2,37,142.29,41.5
"2011","Stoke-on-Trent 011","E02002961","Total",6480,3312,3168,6471,9,39,263.32,24.6
"2011","Stoke-on-Trent 012","E02002962","Total",6958,3350,3608,6921,37,41,295.91,23.5
"2011","Stoke-on-Trent 013","E02002963","Total",7294,3715,3579,7277,17,36,115.78,63.0
"2011","Stoke-on-Trent 014","E02002964","Total",8520,4126,4394,8492,28,27,367.21,23.2
"2011","Stoke-on-Trent 015","E02002965","Total",7126,3926,3200,6722,404,70,395.04,18.0
"2011","Stoke-on-Trent 016","E02002966","Total",9079,5147,3932,8368,711,99,386.78,23.5
"2011","Stoke-on-Trent 017","E02002967","Total",9747,4697,5050,9652,95,30,374.58,26.0
"2011","Stoke-on-Trent 018","E02002968","Total",9030,4471,4559,8921,109,66,280.63,32.2
"2011","Stoke-on-Trent 019","E02002969","Total",8653,4456,4197,8617,36,45,197.08,43.9
"2011","Stoke-on-Trent 020","E02002970","Total",8123,3978,4145,8054,69,35,314.73,25.8
"2011","Stoke-on-Trent 021","E02002971","Total",5252,2635,2617,5252,0,15,159.92,32.8
"2011","Stoke-on-Trent 022","E02002972","Total",6265,3078,3187,6243,22,34,203.79,30.7
"2011","Stoke-on-Trent 023","E02002973","Total",8045,4064,3981,8042,3,49,352.46,22.8
"2011","Stoke-on-Trent 024","E02002974","Total",5622,2763,2859,5492,130,26,197.71,28.4
"2011","Stoke-on-Trent 025","E02002975","Total",7658,3826,3832,7643,15,30,175.34,43.7
"2011","Stoke-on-Trent 026","E02002976","Total",6008,2908,3100,5988,20,23,248.98,24.1
"2011","Stoke-on-Trent 027","E02002977","Total",5884,2832,3052,5762,122,40,186.06,31.6
"2011","Stoke-on-Trent 028","E02002978","Total",6381,3182,3199,6367,14,28,138.15,46.2
"2011","Stoke-on-Trent 029","E02002979","Total",5622,2810,2812,5542,80,25,92.50,60.8
"2011","Stoke-on-Trent 030","E02002980","Total",6082,2957,3125,6051,31,52,355.94,17.1
"2011","Stoke-on-Trent 031","E02002981","Total",8260,4032,4228,8242,18,72,365.76,22.6
"2011","Stoke-on-Trent 032","E02002982","Total",7048,3504,3544,7044,4,44,345.85,20.4
"2011","Stoke-on-Trent 033","E02002983","Total",5580,2785,2795,5578,2,65,194.93,28.6
"2011","Stoke-on-Trent 034","E02002984","Total",5754,2832,2922,5484,270,89,305.20,18.9
"2011","Telford and Wrekin 001","E02002928","Total",6003,2990,3013,5935,68,122,219.40,27.4
"2011","Telford and Wrekin 002","E02002929","Total",6230,3125,3105,5379,851,151,9862.98,0.6
"2011","Telford and Wrekin 003","E02002930","Total",5533,2748,2785,5410,123,75,193.98,28.5
"2011","Telford and Wrekin 004","E02002931","Total",6370,3128,3242,6360,10,76,2508.62,2.5
"2011","Telford and Wrekin 005","E02002932","Total",8620,4264,4356,8485,135,65,368.80,23.4
"2011","Telford and Wrekin 006","E02002933","Total",8207,4044,4163,8155,52,103,246.92,33.2
"2011","Telford and Wrekin 007","E02002934","Total",6007,2927,3080,5987,20,80,329.02,18.3
"2011","Telford and Wrekin 008","E02002935","Total",6679,3283,3396,6671,8,55,260.08,25.7
"2011","Telford and Wrekin 009","E02002936","Total",8616,4234,4382,8594,22,61,639.26,13.5
"2011","Telford and Wrekin 010","E02002937","Total",10133,5131,5002,9917,216,186,9706.91,1.0
"2011","Telford and Wrekin 011","E02002938","Total",6726,3378,3348,6620,106,73,247.38,27.2
"2011","Telford and Wrekin 012","E02002939","Total",6419,3121,3298,6303,116,74,230.18,27.9
"2011","Telford and Wrekin 013","E02002940","Total",6084,2988,3096,6052,32,42,184.59,33.0
"2011","Telford and Wrekin 014","E02002941","Total",9545,4745,4800,9475,70,51,479.37,19.9
"2011","Telford and Wrekin 015","E02002942","Total",6325,3181,3144,6245,80,137,427.84,14.8
"2011","Telford and Wrekin 016","E02002943","Total",9519,4739,4780,9397,122,97,830.64,11.5
"2011","Telford and Wrekin 017","E02002944","Total",7790,3877,3913,7757,33,31,323.97,24.0
"2011","Telford and Wrekin 018","E02002945","Total",9381,4699,4682,9357,24,87,632.30,14.8
"2011","Telford and Wrekin 019","E02002946","Total",7900,3912,3988,7890,10,64,302.15,26.1
"2011","Telford and Wrekin 020","E02002947","Total",6923,3452,3471,6921,2,56,152.84,45.3
"2011","Telford and Wrekin 021","E02002948","Total",6898,3282,3616,6861,37,36,142.97,48.2
"2011","Telford and Wrekin 022","E02002949","Total",5329,2639,2690,5268,61,44,266.41,20.0
"2011","Telford and Wrekin 023","E02002950","Total",5404,2662,2742,5401,3,47,474.71,11.4
"2011","Cannock Chase 001","E02006118","Total",7404,3691,3713,7338,66,65,1734.86,4.3
"2011","Cannock Chase 002","E02006119","Total",8269,4079,4190,8152,117,43,254.80,32.5
"2011","Cannock Chase 003","E02006120","Total",8887,4322,4565,8857,30,57,607.85,14.6
"2011","Cannock Chase 004","E02006121","Total",5548,2781,2767,5546,2,42,993.82,5.6
"2011","Cannock Chase 005","E02006122","Total",6495,3271,3224,6492,3,42,267.59,24.3
"2011","Cannock Chase 006","E02006123","Total",6744,3364,3380,6643,101,66,988.85,6.8
"2011","Cannock Chase 007","E02006124","Total",7286,3590,3696,7272,14,37,147.89,49.3
"2011","Cannock Chase 008","E02006125","Total",7331,3645,3686,7331,0,38,167.28,43.8
"2011","Cannock Chase 009","E02006126","Total",8319,4139,4180,8227,92,75,371.87,22.4
"2011","Cannock Chase 010","E02006127","Total",7628,3737,3891,7514,114,76,173.15,44.1
"2011","Cannock Chase 011","E02006128","Total",8399,4052,4347,8361,38,91,336.66,24.9
"2011","Cannock Chase 012","E02006129","Total",7673,3759,3914,7585,88,37,327.55,23.4
"2011","Cannock Chase 013","E02006130","Total",7479,3696,3783,7473,6,45,1515.92,4.9
"2011","East Staffordshire 001","E02006131","Total",7837,3910,3927,7569,268,149,12432.94,0.6
"2011","East Staffordshire 002","E02006132","Total",6198,3039,3159,6157,41,62,447.12,13.9
"2011","East Staffordshire 003","E02006133","Total",6891,3422,3469,6742,149,112,967.04,7.1
"2011","East Staffordshire 004","E02006134","Total",9164,4489,4675,9138,26,158,3081.96,3.0
"2011","East Staffordshire 005","E02006135","Total",7849,3796,4053,7817,32,99,375.18,20.9
"2011","East Staffordshire 006","E02006136","Total",8648,4629,4019,7624,1024,165,13892.55,0.6
"2011","East Staffordshire 007","E02006137","Total",8751,4206,4545,8643,108,55,181.13,48.3
"2011","East Staffordshire 008","E02006138","Total",6202,3069,3133,6179,23,46,192.30,32.3
"2011","East Staffordshire 009","E02006139","Total",7061,3509,3552,7006,55,54,304.22,23.2
"2011","East Staffordshire 010","E02006140","Total",8466,4127,4339,8327,139,76,236.01,35.9
"2011","East Staffordshire 011","E02006141","Total",10330,5383,4947,10222,108,64,692.34,14.9
"2011","East Staffordshire 012","E02006142","Total",5385,2629,2756,5339,46,85,201.55,26.7
"2011","East Staffordshire 013","E02006143","Total",7231,3578,3653,7206,25,86,966.38,7.5
"2011","East Staffordshire 014","E02006144","Total",7977,3895,4082,7929,48,46,183.37,43.5
"2011","East Staffordshire 015","E02006145","Total",5593,2704,2889,5590,3,112,4542.20,1.2
"2011","Lichfield 001","E02006146","Total",7134,3525,3609,6987,147,87,3632.57,2.0
"2011","Lichfield 002","E02006147","Total",7626,3720,3906,7570,56,157,5690.27,1.3
"2011","Lichfield 003","E02006148","Total",7245,3631,3614,7245,0,125,3114.36,2.3
"2011","Lichfield 004","E02006149","Total",10486,5100,5386,10355,131,97,346.25,30.3
"2011","Lichfield 005","E02006150","Total",11610,5782,5828,11522,88,247,414.11,28.0
"2011","Lichfield 006","E02006151","Total",8792,4309,4483,8721,71,75,779.47,11.3
"2011","Lichfield 007","E02006152","Total",10123,4910,5213,10060,63,164,641.72,15.8
"2011","Lichfield 008","E02006153","Total",7050,3504,3546,6914,136,123,8636.54,0.8
"2011","Lichfield 009","E02006154","Total",9886,4934,4952,9749,137,82,1044.62,9.5
"2011","Lichfield 010","E02006155","Total",5767,2858,2909,5694,73,33,108.10,53.3
"2011","Lichfield 011","E02006156","Total",7792,3769,4023,7602,190,184,3736.94,2.1
"2011","Lichfield 012","E02006157","Total",7143,3878,3265,6474,669,82,4984.76,1.4
"2011","Newcastle-under-Lyme 001","E02006158","Total",8486,4240,4246,8486,0,73,813.62,10.4
"2011","Newcastle-under-Lyme 002","E02006159","Total",5754,2857,2897,5741,13,41,180.10,31.9
"2011","Newcastle-under-Lyme 003","E02006160","Total",8356,4119,4237,8251,105,50,433.34,19.3
"2011","Newcastle-under-Lyme 004","E02006161","Total",7032,3544,3488,7000,32,56,853.45,8.2
"2011","Newcastle-under-Lyme 005","E02006162","Total",8437,4187,4250,8400,37,57,2951.35,2.9
"2011","Newcastle-under-Lyme 006","E02006163","Total",8032,3962,4070,7864,168,43,252.60,31.8
"2011","Newcastle-under-Lyme 007","E02006164","Total",7421,3634,3787,7340,81,37,447.40,16.6
"2011","Newcastle-under-Lyme 008","E02006165","Total",7384,3657,3727,7354,30,43,165.65,44.6
"2011","Newcastle-under-Lyme 009","E02006166","Total",7193,3563,3630,7090,103,89,150.13,47.9
"2011","Newcastle-under-Lyme 010","E02006167","Total",8722,4242,4480,8695,27,60,294.37,29.6
"2011","Newcastle-under-Lyme 011","E02006168","Total",8446,4291,4155,8230,216,64,256.79,32.9
"2011","Newcastle-under-Lyme 012","E02006169","Total",8077,4013,4064,4837,3240,112,1375.70,5.9
"2011","Newcastle-under-Lyme 013","E02006170","Total",5145,2483,2662,5083,62,96,3014.18,1.7
"2011","Newcastle-under-Lyme 014","E02006171","Total",8914,4344,4570,8904,10,103,288.34,30.9
"2011","Newcastle-under-Lyme 015","E02006172","Total",9524,4593,4931,9519,5,186,540.70,17.6
"2011","Newcastle-under-Lyme 016","E02006173","Total",6948,3477,3471,6914,34,138,9078.03,0.8
"2011","South Staffordshire 001","E02006174","Total",10349,5105,5244,10294,55,134,7327.01,1.4
"2011","South Staffordshire 002","E02006175","Total",6616,3266,3350,6571,45,54,2486.89,2.7
"2011","South Staffordshire 003","E02006176","Total",7342,3560,3782,7289,53,124,9133.72,0.8
"2011","South Staffordshire 004","E02006177","Total",9837,4893,4944,9794,43,94,328.40,30.0
"2011","South Staffordshire 005","E02006178","Total",7866,3856,4010,7820,46,65,432.36,18.2
"2011","South Staffordshire 006","E02006179","Total",7356,4054,3302,6544,812,77,1679.62,4.4
"2011","South Staffordshire 007","E02006180","Total",6700,3245,3455,6481,219,67,1799.45,3.7
"2011","South Staffordshire 008","E02006181","Total",5745,2711,3034,5707,38,55,581.01,9.9
"2011","South Staffordshire 009","E02006182","Total",6750,3253,3497,6608,142,136,1218.36,5.5
"2011","South Staffordshire 010","E02006183","Total",7502,3692,3810,7397,105,148,3339.95,2.2
"2011","South Staffordshire 011","E02006184","Total",5430,2636,2794,5426,4,67,114.17,47.6
"2011","South Staffordshire 012","E02006185","Total",7196,3459,3737,7115,81,70,729.40,9.9
"2011","South Staffordshire 013","E02006186","Total",12217,6047,6170,12044,173,188,7364.73,1.7
"2011","South Staffordshire 014","E02006187","Total",7225,3466,3759,7067,158,152,4196.45,1.7
"2011","Stafford 001","E02006188","Total",5931,2911,3020,5844,87,87,1490.57,4.0
"2011","Stafford 002","E02006189","Total",7170,3478,3692,7035,135,118,7064.43,1.0
"2011","Stafford 003","E02006190","Total",10334,5039,5295,10130,204,104,551.97,18.7
"2011","Stafford 004","E02006191","Total",8005,3921,4084,7928,77,153,5726.43,1.4
"2011","Stafford 005","E02006192","Total",8110,3917,4193,7789,321,199,12846.12,0.6
"2011","Stafford 006","E02006193","Total",6471,3223,3248,6464,7,82,2324.51,2.8
"2011","Stafford 007","E02006194","Total",7659,3686,3973,7585,74,61,379.97,20.2
"2011","Stafford 008","E02006195","Total",8315,4071,4244,8225,90,143,7447.27,1.1
"2011","Stafford 009","E02006196","Total",7187,4279,2908,6392,795,72,150.59,47.7
"2011","Stafford 010","E02006197","Total",8235,4410,3825,8106,129,56,311.92,26.4
"2011","Stafford 011","E02006198","Total",8477,4512,3965,7465,1012,168,2970.88,2.9
"2011","Stafford 012","E02006199","Total",8209,4061,4148,7957,252,155,4012.48,2.0
"2011","Stafford 013","E02006200","Total",7983,3844,4139,7983,0,48,174.47,45.8
"2011","Stafford 014","E02006201","Total",12199,5963,6236,12199,0,250,1495.86,8.2
"2011","Stafford 015","E02006202","Total",8670,4332,4338,8607,63,175,12541.37,0.7
"2011","Stafford 016","E02006203","Total",7914,3907,4007,7900,14,57,328.42,24.1
"2011","Staffordshire Moorlands 001","E02006204","Total",7318,3559,3759,7214,104,76,9356.32,0.8
"2011","Staffordshire Moorlands 002","E02006205","Total",7038,3557,3481,6989,49,102,5582.82,1.3
"2011","Staffordshire Moorlands 003","E02006206","Total",8358,3988,4370,8264,94,53,201.27,41.5
"2011","Staffordshire Moorlands 004","E02006207","Total",6305,3077,3228,6246,59,60,1240.54,5.1
"2011","Staffordshire Moorlands 005","E02006208","Total",8157,4009,4148,8028,129,77,421.14,19.4
"2011","Staffordshire Moorlands 006","E02006209","Total",10869,5292,5577,10712,157,147,2366.51,4.6
"2011","Staffordshire Moorlands 007","E02006210","Total",5486,2771,2715,5428,58,85,18937.76,0.3
"2011","Staffordshire Moorlands 008","E02006211","Total",6472,3166,3306,6422,50,93,2521.02,2.6
"2011","Staffordshire Moorlands 009","E02006212","Total",7875,3865,4010,7678,197,77,2880.00,2.7
"2011","Staffordshire Moorlands 010","E02006213","Total",6555,3279,3276,6426,129,74,5567.10,1.2
"2011","Staffordshire Moorlands 011","E02006214","Total",6119,3004,3115,6005,114,57,739.13,8.3
"2011","Staffordshire Moorlands 012","E02006215","Total",7844,3889,3955,7783,61,80,4428.53,1.8
"2011","Staffordshire Moorlands 013","E02006216","Total",8710,4334,4376,8665,45,129,3342.57,2.6
"2011","Tamworth 001","E02006217","Total",8817,4235,4582,8647,170,116,590.41,14.9
"2011","Tamworth 002","E02006218","Total",7851,3801,4050,7796,55,51,421.38,18.6
"2011","Tamworth 003","E02006219","Total",7887,3907,3980,7873,14,73,470.36,16.8
"2011","Tamworth 004","E02006220","Total",7398,3614,3784,7390,8,58,164.76,44.9
"2011","Tamworth 005","E02006221","Total",6087,3084,3003,6087,0,72,278.87,21.8
"2011","Tamworth 006","E02006222","Total",6859,3352,3507,6771,88,39,133.05,51.6
"2011","Tamworth 007","E02006223","Total",7170,3454,3716,7158,12,22,122.86,58.4
"2011","Tamworth 008","E02006224","Total",7692,3787,3905,7692,0,69,246.42,31.2
"2011","Tamworth 009","E02006225","Total",7375,3665,3710,7375,0,95,293.93,25.1
"2011","Tamworth 010","E02006226","Total",9677,4795,4882,9657,20,90,362.58,26.7
"2011","North Warwickshire 001","E02006468","Total",10486,5182,5304,10384,102,150,3987.21,2.6
"2011","North Warwickshire 002","E02006469","Total",8708,4311,4397,8660,48,71,3356.32,2.6
"2011","North Warwickshire 003","E02006470","Total",11003,5430,5573,10929,74,93,1239.39,8.9
"2011","North Warwickshire 004","E02006471","Total",6925,3444,3481,6925,0,89,4995.27,1.4
"2011","North Warwickshire 005","E02006472","Total",8940,4378,4562,8845,95,89,4634.30,1.9
"2011","North Warwickshire 006","E02006473","Total",9925,4809,5116,9779,146,103,1731.04,5.7
"2011","North Warwickshire 007","E02006474","Total",6027,3050,2977,5946,81,61,8483.16,0.7
"2011","Nuneaton and Bedworth 001","E02006475","Total",7256,3521,3735,7220,36,119,611.77,11.9
"2011","Nuneaton and Bedworth 002","E02006476","Total",7321,3529,3792,7275,46,27,285.09,25.7
"2011","Nuneaton and Bedworth 003","E02006477","Total",6943,3452,3491,6863,80,149,453.39,15.3
"2011","Nuneaton and Bedworth 004","E02006478","Total",8233,4106,4127,8233,0,90,457.45,18.0
"2011","Nuneaton and Bedworth 005","E02006479","Total",8718,4374,4344,8663,55,72,198.98,43.8
"2011","Nuneaton and Bedworth 006","E02006480","Total",7452,3687,3765,7452,0,55,178.15,41.8
"2011","Nuneaton and Bedworth 007","E02006481","Total",6878,3379,3499,6873,5,33,202.94,33.9
"2011","Nuneaton and Bedworth 008","E02006482","Total",6736,3334,3402,6666,70,66,1193.88,5.6
"2011","Nuneaton and Bedworth 009","E02006483","Total",7787,3785,4002,7721,66,47,370.19,21.0
"2011","Nuneaton and Bedworth 010","E02006484","Total",7676,3713,3963,7565,111,76,194.08,39.6
"2011","Nuneaton and Bedworth 011","E02006485","Total",6877,3393,3484,6876,1,147,552.11,12.5
"2011","Nuneaton and Bedworth 012","E02006486","Total",7041,3500,3541,7005,36,53,448.91,15.7
"2011","Nuneaton and Bedworth 013","E02006487","Total",6666,3196,3470,6591,75,44,158.20,42.1
"2011","Nuneaton and Bedworth 014","E02006488","Total",6146,3002,3144,6137,9,55,1370.47,4.5
"2011","Nuneaton and Bedworth 015","E02006489","Total",8043,4002,4041,8034,9,60,321.37,25.0
"2011","Nuneaton and Bedworth 016","E02006490","Total",7473,3622,3851,7424,49,69,339.65,22.0
"2011","Nuneaton and Bedworth 018","E02006806","Total",8006,3846,4160,7812,194,59,558.51,14.3
"2011","Rugby 001","E02006492","Total",11104,5657,5447,10629,475,180,15818.75,0.7
"2011","Rugby 002","E02006493","Total",9047,4469,4578,9041,6,127,334.48,27.0
"2011","Rugby 003","E02006494","Total",6754,3426,3328,6655,99,49,358.03,18.9
"2011","Rugby 004","E02006495","Total",7685,3848,3837,7636,49,110,3319.01,2.3
"2011","Rugby 005","E02006496","Total",6937,3611,3326,6893,44,84,189.55,36.6
"2011","Rugby 006","E02006497","Total",7760,3875,3885,7721,39,66,304.83,25.5
"2011","Rugby 007","E02006498","Total",11324,5646,5678,11321,3,173,2277.97,5.0
"2011","Rugby 008","E02006499","Total",5915,2935,2980,5913,2,104,184.03,32.1
"2011","Rugby 009","E02006500","Total",5865,2936,2929,5121,744,118,539.69,10.9
"2011","Rugby 010","E02006501","Total",9024,4501,4523,8964,60,99,573.20,15.7
"2011","Rugby 011","E02006502","Total",10801,5152,5649,10554,247,142,307.04,35.2
"2011","Rugby 012","E02006503","Total",7859,3828,4031,7732,127,197,10904.83,0.7
"2011","Stratford-on-Avon 001","E02006504","Total",5679,2798,2881,5613,66,116,8138.09,0.7
"2011","Stratford-on-Avon 002","E02006505","Total",6656,3182,3474,6624,32,142,5155.42,1.3
"2011","Stratford-on-Avon 003","E02006506","Total",5879,2859,3020,5824,55,64,861.63,6.8
"2011","Stratford-on-Avon 004","E02006507","Total",9058,4466,4592,8982,76,160,4319.17,2.1
"2011","Stratford-on-Avon 005","E02006508","Total",9442,4616,4826,9401,41,172,14374.10,0.7
"2011","Stratford-on-Avon 006","E02006509","Total",6083,2932,3151,6023,60,100,2090.78,2.9
"2011","Stratford-on-Avon 007","E02006510","Total",6182,3023,3159,6071,111,140,7985.79,0.8
"2011","Stratford-on-Avon 008","E02006511","Total",9164,4400,4764,8932,232,200,7841.78,1.2
"2011","Stratford-on-Avon 009","E02006512","Total",10901,5377,5524,10742,159,111,684.29,15.9
"2011","Stratford-on-Avon 010","E02006513","Total",7487,3624,3863,7385,102,178,1683.06,4.4
"2011","Stratford-on-Avon 011","E02006514","Total",9057,4217,4840,8829,228,138,388.88,23.3
"2011","Stratford-on-Avon 012","E02006515","Total",9223,4504,4719,9054,169,151,6044.42,1.5
"2011","Stratford-on-Avon 013","E02006516","Total",9019,4449,4570,8816,203,190,14109.76,0.6
"2011","Stratford-on-Avon 014","E02006517","Total",7358,3585,3773,7305,53,176,11813.21,0.6
"2011","Stratford-on-Avon 015","E02006518","Total",9297,4465,4832,9252,45,201,12296.25,0.8
"2011","Warwick 001","E02006519","Total",7565,3665,3900,7501,64,173,1801.04,4.2
"2011","Warwick 002","E02006520","Total",8388,4115,4273,8388,0,206,506.41,16.6
"2011","Warwick 003","E02006521","Total",7463,3668,3795,7408,55,162,496.47,15.0
"2011","Warwick 004","E02006522","Total",5464,2731,2733,5441,23,173,8053.61,0.7
"2011","Warwick 005","E02006523","Total",11628,5722,5906,9921,1707,236,8410.48,1.4
"2011","Warwick 006","E02006524","Total",5624,2779,2845,5579,45,52,95.89,58.7
"2011","Warwick 007","E02006525","Total",12862,6428,6434,12592,270,215,267.56,48.1
"2011","Warwick 008","E02006526","Total",8318,4137,4181,8283,35,98,394.35,21.1
"2011","Warwick 009","E02006527","Total",9166,4595,4571,8802,364,143,251.57,36.4
"2011","Warwick 010","E02006528","Total",11142,5645,5497,11001,141,102,485.61,22.9
"2011","Warwick 011","E02006529","Total",11304,5628,5676,11238,66,99,796.60,14.2
"2011","Warwick 012","E02006530","Total",10492,5210,5282,10366,126,202,855.42,12.3
"2011","Warwick 013","E02006531","Total",9931,5326,4605,9828,103,87,190.01,52.3
"2011","Warwick 014","E02006532","Total",8729,4300,4429,8721,8,192,5199.72,1.7
"2011","Warwick 015","E02006533","Total",9572,4701,4871,9521,51,124,483.56,19.8
"2011","Birmingham 001","E02001827","Total",6045,2902,3143,6044,1,101,231.51,26.1
"2011","Birmingham 002","E02001828","Total",6920,3275,3645,6877,43,122,321.88,21.5
"2011","Birmingham 003","E02001829","Total",8735,4265,4470,8731,4,180,542.97,16.1
"2011","Birmingham 004","E02001830","Total",9437,4545,4892,9311,126,276,1311.98,7.2
"2011","Birmingham 005","E02001831","Total",10326,4898,5428,10285,41,118,250.41,41.2
"2011","Birmingham 006","E02001832","Total",8168,4002,4166,8163,5,143,342.70,23.8
"2011","Birmingham 007","E02001833","Total",5808,2855,2953,5805,3,70,152.36,38.1
"2011","Birmingham 008","E02001834","Total",6139,2893,3246,6139,0,33,106.86,57.4
"2011","Birmingham 009","E02001835","Total",8176,4002,4174,8002,174,198,236.07,34.6
"2011","Birmingham 010","E02001836","Total",9180,4478,4702,9142,38,157,230.65,39.8
"2011","Birmingham 011","E02001837","Total",10585,5091,5494,10556,29,44,148.43,71.3
"2011","Birmingham 012","E02001838","Total",7673,3726,3947,7618,55,165,1140.87,6.7
"2011","Birmingham 013","E02001839","Total",6442,3065,3377,6408,34,27,184.84,34.9
"2011","Birmingham 014","E02001840","Total",8771,4123,4648,8678,93,55,154.95,56.6
"2011","Birmingham 015","E02001841","Total",5993,2918,3075,5945,48,129,230.50,26.0
"2011","Birmingham 016","E02001842","Total",7663,3708,3955,7655,8,52,141.65,54.1
"2011","Birmingham 017","E02001843","Total",6455,3165,3290,6423,32,31,125.21,51.6
"2011","Birmingham 018","E02001844","Total",9716,4750,4966,9533,183,125,192.19,50.6
"2011","Birmingham 019","E02001845","Total",6274,3004,3270,6274,0,43,115.20,54.5
"2011","Birmingham 020","E02001846","Total",7829,3819,4010,7802,27,48,130.74,59.9
"2011","Birmingham 021","E02001847","Total",5521,2693,2828,5521,0,72,743.72,7.4
"2011","Birmingham 022","E02001848","Total",6372,2959,3413,6291,81,28,200.34,31.8
"2011","Birmingham 023","E02001849","Total",6882,3356,3526,6838,44,42,133.35,51.6
"2011","Birmingham 024","E02001850","Total",8173,3969,4204,8167,6,62,237.39,34.4
"2011","Birmingham 025","E02001851","Total",8576,4126,4450,8489,87,65,220.14,39.0
"2011","Birmingham 026","E02001852","Total",6544,3212,3332,6512,32,39,119.36,54.8
"2011","Birmingham 028","E02001854","Total",7777,3807,3970,7733,44,52,336.04,23.1
"2011","Birmingham 029","E02001855","Total",9971,4582,5389,9826,145,46,308.46,32.3
"2011","Birmingham 030","E02001856","Total",8512,4253,4259,8459,53,65,192.87,44.1
"2011","Birmingham 031","E02001857","Total",12902,6439,6463,12583,319,87,273.82,47.1
"2011","Birmingham 032","E02001858","Total",8453,4213,4240,7975,478,117,163.91,51.6
"2011","Birmingham 033","E02001859","Total",10115,5100,5015,9407,708,95,340.88,29.7
"2011","Birmingham 034","E02001860","Total",8337,4198,4139,8337,0,75,99.18,84.1
"2011","Birmingham 035","E02001861","Total",10161,5251,4910,10114,47,105,116.84,87.0
"2011","Birmingham 036","E02001862","Total",9904,4851,5053,9897,7,75,222.27,44.6
"2011","Birmingham 037","E02001863","Total",7839,3949,3890,7806,33,29,227.05,34.5
"2011","Birmingham 038","E02001864","Total",5531,2639,2892,5531,0,40,94.84,58.3
"2011","Birmingham 039","E02001865","Total",10932,5612,5320,10912,20,71,121.95,89.6
"2011","Birmingham 040","E02001866","Total",8671,4454,4217,8561,110,28,86.13,100.7
"2011","Birmingham 041","E02001867","Total",6901,3353,3548,6875,26,67,91.75,75.2
"2011","Birmingham 042","E02001868","Total",8617,4174,4443,8557,60,58,177.22,48.6
"2011","Birmingham 043","E02001869","Total",6060,2926,3134,6056,4,41,272.98,22.2
"2011","Birmingham 044","E02001870","Total",11560,5646,5914,11471,89,66,175.86,65.7
"2011","Birmingham 045","E02001871","Total",7721,3621,4100,7640,81,22,166.88,46.3
"2011","Birmingham 046","E02001872","Total",7161,3342,3819,7158,3,33,194.65,36.8
"2011","Birmingham 047","E02001873","Total",10534,5249,5285,10442,92,61,183.79,57.3
"2011","Birmingham 048","E02001874","Total",9352,4693,4659,9296,56,51,189.93,49.2
"2011","Birmingham 049","E02001875","Total",8168,4108,4060,8133,35,75,143.61,56.9
"2011","Birmingham 050","E02001876","Total",11909,6019,5890,7300,4609,153,320.15,37.2
"2011","Birmingham 051","E02001877","Total",10655,5379,5276,10615,40,82,124.18,85.8
"2011","Birmingham 052","E02001878","Total",8955,4474,4481,8949,6,50,220.15,40.7
"2011","Birmingham 053","E02001879","Total",10376,5446,4930,9490,886,66,162.69,63.8
"2011","Birmingham 054","E02001880","Total",9434,4456,4978,9429,5,43,133.78,70.5
"2011","Birmingham 055","E02001881","Total",9334,4616,4718,9334,0,30,147.81,63.1
"2011","Birmingham 056","E02001882","Total",8152,4025,4127,8028,124,50,156.31,52.2
"2011","Birmingham 057","E02001883","Total",8129,3863,4266,8129,0,24,234.85,34.6
"2011","Birmingham 058","E02001884","Total",9239,4594,4645,9233,6,50,129.12,71.6
"2011","Birmingham 060","E02001886","Total",8808,4595,4213,8657,151,101,200.20,44.0
"2011","Birmingham 062","E02001888","Total",6247,3006,3241,6161,86,29,124.57,50.1
"2011","Birmingham 063","E02001889","Total",8346,4155,4191,8246,100,26,92.82,89.9
"2011","Birmingham 064","E02001890","Total",9806,5045,4761,9389,417,121,248.68,39.4
"2011","Birmingham 066","E02001892","Total",10193,4946,5247,10189,4,39,207.09,49.2
"2011","Birmingham 067","E02001893","Total",8097,4009,4088,8035,62,68,160.73,50.4
"2011","Birmingham 069","E02001895","Total",7790,3725,4065,7680,110,24,246.34,31.6
"2011","Birmingham 070","E02001896","Total",9287,4715,4572,9269,18,73,112.15,82.8
"2011","Birmingham 071","E02001897","Total",7596,3957,3639,7521,75,25,187.71,40.5
"2011","Birmingham 072","E02001898","Total",6488,3185,3303,6488,0,60,110.01,59.0
"2011","Birmingham 073","E02001899","Total",7866,3796,4070,7755,111,180,230.06,34.2
"2011","Birmingham 074","E02001900","Total",6801,3373,3428,6219,582,112,158.61,42.9
"2011","Birmingham 075","E02001901","Total",7902,3765,4137,7752,150,129,167.14,47.3
"2011","Birmingham 076","E02001902","Total",6101,3013,3088,6101,0,43,113.06,54.0
"2011","Birmingham 077","E02001903","Total",7600,3878,3722,7597,3,61,72.48,104.9
"2011","Birmingham 078","E02001904","Total",6939,3430,3509,6808,131,40,238.35,29.1
"2011","Birmingham 079","E02001905","Total",9716,4783,4933,6065,3651,187,439.64,22.1
"2011","Birmingham 080","E02001906","Total",9315,4458,4857,9315,0,82,184.74,50.4
"2011","Birmingham 081","E02001907","Total",9622,4817,4805,9608,14,58,287.92,33.4
"2011","Birmingham 082","E02001908","Total",8908,4486,4422,8896,12,37,53.03,168.0
"2011","Birmingham 083","E02001909","Total",7986,4095,3891,7941,45,74,86.42,92.4
"2011","Birmingham 084","E02001910","Total",7117,3592,3525,7105,12,55,87.96,80.9
"2011","Birmingham 085","E02001911","Total",7935,3768,4167,7935,0,52,138.62,57.2
"2011","Birmingham 087","E02001913","Total",7186,3587,3599,7095,91,65,248.74,28.9
"2011","Birmingham 088","E02001914","Total",6790,3470,3320,6686,104,97,234.69,28.9
"2011","Birmingham 089","E02001915","Total",11507,5722,5785,11339,168,91,193.01,59.6
"2011","Birmingham 090","E02001916","Total",8612,4196,4416,8499,113,60,145.69,59.1
"2011","Birmingham 092","E02001918","Total",8956,4662,4294,8682,274,118,164.57,54.4
"2011","Birmingham 093","E02001919","Total",6689,3419,3270,6520,169,89,109.64,61.0
"2011","Birmingham 094","E02001920","Total",7587,3554,4033,7579,8,37,277.86,27.3
"2011","Birmingham 095","E02001921","Total",7833,3701,4132,7792,41,67,199.17,39.3
"2011","Birmingham 096","E02001922","Total",12650,5895,6755,11409,1241,129,141.84,89.2
"2011","Birmingham 097","E02001923","Total",10457,5119,5338,10427,30,116,174.37,60.0
"2011","Birmingham 098","E02001924","Total",6456,3185,3271,6449,7,60,115.80,55.8
"2011","Birmingham 099","E02001925","Total",6684,3179,3505,6548,136,72,220.93,30.3
"2011","Birmingham 100","E02001926","Total",7214,3671,3543,6830,384,90,176.30,40.9
"2011","Birmingham 101","E02001927","Total",7702,3663,4039,7634,68,53,152.07,50.6
"2011","Birmingham 102","E02001928","Total",6858,3262,3596,6850,8,33,160.75,42.7
"2011","Birmingham 103","E02001929","Total",9649,4629,5020,9626,23,55,139.67,69.1
"2011","Birmingham 104","E02001930","Total",7858,3881,3977,7845,13,116,128.65,61.1
"2011","Birmingham 105","E02001931","Total",7886,3854,4032,7884,2,113,251.43,31.4
"2011","Birmingham 106","E02001932","Total",6795,3180,3615,6586,209,40,332.95,20.4
"2011","Birmingham 107","E02001933","Total",7625,3663,3962,7512,113,59,166.01,45.9
"2011","Birmingham 108","E02001934","Total",6811,3365,3446,6782,29,68,120.36,56.6
"2011","Birmingham 109","E02001935","Total",7839,3733,4106,7811,28,71,196.85,39.8
"2011","Birmingham 110","E02001936","Total",6473,3148,3325,6438,35,111,123.33,52.5
"2011","Birmingham 111","E02001937","Total",7923,3773,4150,7871,52,67,183.53,43.2
"2011","Birmingham 112","E02001938","Total",7726,3715,4011,7560,166,90,185.19,41.7
"2011","Birmingham 113","E02001939","Total",5812,2810,3002,5807,5,51,171.82,33.8
"2011","Birmingham 115","E02001941","Total",6202,2962,3240,6098,104,29,140.01,44.3
"2011","Birmingham 116","E02001942","Total",6767,3231,3536,6673,94,84,115.43,58.6
"2011","Birmingham 117","E02001943","Total",6394,3071,3323,6363,31,43,167.97,38.1
"2011","Birmingham 118","E02001944","Total",8126,3978,4148,8051,75,53,186.92,43.5
"2011","Birmingham 119","E02001945","Total",7784,3707,4077,7777,7,45,160.74,48.4
"2011","Birmingham 120","E02001946","Total",7688,3848,3840,7619,69,89,180.24,42.7
"2011","Birmingham 121","E02001947","Total",6165,2986,3179,6115,50,25,122.75,50.2
"2011","Birmingham 122","E02001948","Total",7433,3670,3763,7387,46,35,125.04,59.4
"2011","Birmingham 123","E02001949","Total",5819,2727,3092,5695,124,33,190.50,30.5
"2011","Birmingham 124","E02001950","Total",8406,4080,4326,8363,43,53,189.20,44.4
"2011","Birmingham 125","E02001951","Total",8217,3975,4242,8200,17,23,161.82,50.8
"2011","Birmingham 126","E02001952","Total",8895,4257,4638,8890,5,38,166.67,53.4
"2011","Birmingham 127","E02001953","Total",7131,3453,3678,7008,123,66,217.42,32.8
"2011","Birmingham 128","E02001954","Total",7812,3726,4086,7784,28,40,184.37,42.4
"2011","Birmingham 129","E02001955","Total",6381,3069,3312,6307,74,25,284.65,22.4
"2011","Birmingham 130","E02001956","Total",6406,3088,3318,6367,39,57,162.02,39.5
"2011","Birmingham 131","E02001957","Total",7912,3891,4021,7889,23,46,134.22,58.9
"2011","Birmingham 132","E02006807","Total",7903,3874,4029,7891,12,108,144.53,54.7
"2011","Birmingham 133","E02006809","Total",10032,4890,5142,9956,76,159,372.22,27.0
"2011","Birmingham 134","E02006895","Total",7273,3683,3590,6136,1137,65,87.10,83.5
"2011","Birmingham 135","E02006896","Total",5268,3125,2143,5216,52,25,125.96,41.8
"2011","Birmingham 136","E02006897","Total",6376,3478,2898,5774,602,54,84.66,75.3
"2011","Birmingham 137","E02006898","Total",6184,3373,2811,6169,15,21,103.31,59.9
"2011","Birmingham 138","E02006899","Total",5547,3240,2307,5342,205,26,111.75,49.6
"2011","Birmingham 139","E02006900","Total",14713,7335,7378,14632,81,77,201.45,73.0
"2011","Birmingham 140","E02006901","Total",14402,7330,7072,14386,16,93,238.10,60.5
"2011","Coventry 001","E02001958","Total",7452,3644,3808,7422,30,62,268.69,27.7
"2011","Coventry 002","E02001959","Total",6201,3081,3120,6110,91,45,429.11,14.5
"2011","Coventry 004","E02001961","Total",7498,3723,3775,7484,14,37,150.87,49.7
"2011","Coventry 005","E02001962","Total",6034,2871,3163,6017,17,50,143.31,42.1
"2011","Coventry 006","E02001963","Total",5926,2874,3052,5908,18,61,127.58,46.4
"2011","Coventry 007","E02001964","Total",8092,3782,4310,8019,73,39,331.12,24.4
"2011","Coventry 008","E02001965","Total",8019,3873,4146,7977,42,104,225.22,35.6
"2011","Coventry 009","E02001966","Total",6922,3504,3418,6888,34,59,117.30,59.0
"2011","Coventry 010","E02001967","Total",6281,3063,3218,6147,134,85,1634.35,3.8
"2011","Coventry 011","E02001968","Total",7147,3475,3672,7147,0,61,159.20,44.9
"2011","Coventry 012","E02001969","Total",6377,3039,3338,6332,45,40,92.54,68.9
"2011","Coventry 013","E02001970","Total",5482,2702,2780,5436,46,43,175.74,31.2
"2011","Coventry 014","E02001971","Total",5834,2825,3009,5834,0,68,112.03,52.1
"2011","Coventry 015","E02001972","Total",10054,5157,4897,9935,119,81,189.42,53.1
"2011","Coventry 016","E02001973","Total",8132,4098,4034,8111,21,57,128.33,63.4
"2011","Coventry 017","E02001974","Total",9472,4563,4909,9436,36,116,204.42,46.3
"2011","Coventry 018","E02001975","Total",7860,3810,4050,7854,6,76,118.76,66.2
"2011","Coventry 019","E02001976","Total",7132,3517,3615,7085,47,77,338.43,21.1
"2011","Coventry 020","E02001977","Total",9014,4705,4309,8818,196,62,147.03,61.3
"2011","Coventry 021","E02001978","Total",6503,3258,3245,6471,32,66,99.83,65.1
"2011","Coventry 022","E02001979","Total",5726,2759,2967,5678,48,69,139.58,41.0
"2011","Coventry 023","E02001980","Total",5996,2948,3048,5972,24,75,137.24,43.7
"2011","Coventry 024","E02001981","Total",11753,6162,5591,10927,826,126,123.66,95.0
"2011","Coventry 025","E02001982","Total",7062,3467,3595,7062,0,77,205.83,34.3
"2011","Coventry 026","E02001983","Total",7546,3701,3845,7492,54,74,206.60,36.5
"2011","Coventry 027","E02001984","Total",8967,4421,4546,8829,138,80,159.47,56.2
"2011","Coventry 028","E02001985","Total",8453,4610,3843,7370,1083,100,121.00,69.9
"2011","Coventry 029","E02001986","Total",7597,3677,3920,7503,94,60,199.45,38.1
"2011","Coventry 030","E02001987","Total",5785,3031,2754,5775,10,51,83.45,69.3
"2011","Coventry 031","E02001988","Total",8786,4985,3801,6903,1883,116,218.40,40.2
"2011","Coventry 032","E02001989","Total",5653,2781,2872,5626,27,30,130.24,43.4
"2011","Coventry 033","E02001990","Total",9256,4548,4708,9184,72,119,227.17,40.7
"2011","Coventry 034","E02001991","Total",8515,4262,4253,8379,136,218,334.27,25.5
"2011","Coventry 035","E02001992","Total",9573,4563,5010,9526,47,80,285.82,33.5
"2011","Coventry 036","E02001993","Total",7240,3571,3669,7202,38,87,406.68,17.8
"2011","Coventry 037","E02001994","Total",8159,3954,4205,8099,60,98,137.72,59.2
"2011","Coventry 038","E02001995","Total",6515,3332,3183,6368,147,45,455.54,14.3
"2011","Coventry 039","E02001996","Total",6819,3414,3405,6781,38,37,153.41,44.4
"2011","Coventry 040","E02001997","Total",8526,4189,4337,8510,16,176,216.84,39.3
"2011","Coventry 041","E02001998","Total",5973,2932,3041,5973,0,120,130.98,45.6
"2011","Coventry 042","E02001999","Total",9398,4784,4614,5935,3463,213,466.78,20.1
"2011","Coventry 043","E02006805","Total",8230,3966,4264,8205,25,80,131.01,62.8
"2011","Dudley 001","E02002000","Total",7782,3801,3981,7778,4,29,233.73,33.3
"2011","Dudley 002","E02002001","Total",5951,2935,3016,5944,7,27,199.66,29.8
"2011","Dudley 003","E02002002","Total",7084,3439,3645,7016,68,69,240.15,29.5
"2011","Dudley 004","E02002003","Total",9101,4446,4655,9034,67,53,217.38,41.9
"2011","Dudley 005","E02002004","Total",7518,3626,3892,7431,87,41,168.60,44.6
"2011","Dudley 006","E02002005","Total",8090,3880,4210,8047,43,35,306.04,26.4
"2011","Dudley 007","E02002006","Total",6400,3175,3225,6400,0,34,136.95,46.7
"2011","Dudley 008","E02002007","Total",8731,4281,4450,8725,6,53,284.20,30.7
"2011","Dudley 009","E02002008","Total",8329,4126,4203,8220,109,95,217.55,38.3
"2011","Dudley 010","E02002009","Total",6710,3232,3478,6707,3,43,122.54,54.8
"2011","Dudley 011","E02002010","Total",7186,3652,3534,7020,166,51,209.19,34.4
"2011","Dudley 012","E02002011","Total",5864,2832,3032,5789,75,60,321.37,18.2
"2011","Dudley 013","E02002012","Total",7790,3872,3918,7678,112,33,244.46,31.9
"2011","Dudley 014","E02002013","Total",6697,3251,3446,6589,108,88,190.80,35.1
"2011","Dudley 015","E02002014","Total",6929,3407,3522,6865,64,39,207.46,33.4
"2011","Dudley 016","E02002015","Total",6024,3027,2997,5982,42,38,225.69,26.7
"2011","Dudley 017","E02002016","Total",7826,3804,4022,7795,31,29,253.66,30.9
"2011","Dudley 018","E02002017","Total",8279,4144,4135,8146,133,43,243.40,34.0
"2011","Dudley 019","E02002018","Total",9036,4436,4600,9004,32,121,217.17,41.6
"2011","Dudley 020","E02002019","Total",7857,3902,3955,7857,0,31,259.82,30.2
"2011","Dudley 021","E02002020","Total",9451,4647,4804,9309,142,67,246.04,38.4
"2011","Dudley 022","E02002021","Total",7315,3735,3580,7249,66,47,291.35,25.1
"2011","Dudley 023","E02002022","Total",8324,4035,4289,8280,44,50,205.25,40.6
"2011","Dudley 024","E02002023","Total",5339,2624,2715,5339,0,37,91.19,58.5
"2011","Dudley 025","E02002024","Total",8536,4166,4370,8488,48,38,219.92,38.8
"2011","Dudley 026","E02002025","Total",7961,3925,4036,7943,18,48,220.88,36.0
"2011","Dudley 027","E02002026","Total",7087,3547,3540,7087,0,57,156.79,45.2
"2011","Dudley 028","E02002027","Total",5659,2806,2853,5659,0,72,119.64,47.3
"2011","Dudley 029","E02002028","Total",5846,2795,3051,5781,65,49,125.15,46.7
"2011","Dudley 030","E02002029","Total",5876,2838,3038,5846,30,82,190.19,30.9
"2011","Dudley 031","E02002030","Total",6274,3045,3229,6220,54,48,172.10,36.5
"2011","Dudley 032","E02002031","Total",6005,3007,2998,5914,91,51,180.27,33.3
"2011","Dudley 033","E02002032","Total",9940,4809,5131,9910,30,58,259.87,38.2
"2011","Dudley 034","E02002033","Total",7455,3654,3801,7446,9,76,288.89,25.8
"2011","Dudley 035","E02002034","Total",8113,4066,4047,8053,60,110,179.24,45.3
"2011","Dudley 036","E02002035","Total",6145,2990,3155,6065,80,80,513.55,12.0
"2011","Dudley 037","E02002036","Total",6575,3314,3261,6560,15,27,229.02,28.7
"2011","Dudley 038","E02002037","Total",5874,2862,3012,5859,15,77,152.16,38.6
"2011","Dudley 039","E02002038","Total",9410,4629,4781,9377,33,94,202.54,46.5
"2011","Dudley 040","E02002039","Total",6327,3238,3089,5855,472,116,167.55,37.8
"2011","Dudley 041","E02002040","Total",5967,2904,3063,5927,40,125,417.15,14.3
"2011","Dudley 042","E02002041","Total",6202,2996,3206,6167,35,90,285.73,21.7
"2011","Dudley 043","E02002042","Total",8060,3919,4141,8037,23,124,381.37,21.1
"2011","Sandwell 001","E02002043","Total",8480,4156,4324,8347,133,38,207.13,40.9
"2011","Sandwell 002","E02002044","Total",7498,3592,3906,7498,0,70,171.96,43.6
"2011","Sandwell 003","E02002045","Total",7754,3755,3999,7754,0,45,207.83,37.3
"2011","Sandwell 004","E02002046","Total",5626,2691,2935,5626,0,18,100.92,55.7
"2011","Sandwell 005","E02002047","Total",6465,3152,3313,6331,134,47,253.36,25.5
"2011","Sandwell 006","E02002048","Total",6420,3162,3258,6420,0,98,285.60,22.5
"2011","Sandwell 007","E02002049","Total",5932,2975,2957,5920,12,15,155.98,38.0
"2011","Sandwell 009","E02002051","Total",5517,2665,2852,5467,50,14,106.97,51.6
"2011","Sandwell 010","E02002052","Total",10650,5166,5484,10467,183,72,248.22,42.9
"2011","Sandwell 011","E02002053","Total",5975,2923,3052,5970,5,52,103.44,57.8
"2011","Sandwell 012","E02002054","Total",5583,2694,2889,5579,4,49,172.85,32.3
"2011","Sandwell 013","E02002055","Total",9053,4451,4602,9050,3,64,354.40,25.5
"2011","Sandwell 014","E02002056","Total",8624,4317,4307,8547,77,18,205.21,42.0
"2011","Sandwell 015","E02002057","Total",8996,4394,4602,8917,79,34,204.40,44.0
"2011","Sandwell 016","E02002058","Total",11677,5790,5887,11579,98,60,344.33,33.9
"2011","Sandwell 017","E02002059","Total",10533,5210,5323,10380,153,67,402.73,26.2
"2011","Sandwell 018","E02002060","Total",6273,3193,3080,6250,23,38,258.79,24.2
"2011","Sandwell 019","E02002061","Total",5802,3011,2791,5731,71,29,184.13,31.5
"2011","Sandwell 020","E02002062","Total",7166,3695,3471,7080,86,37,320.28,22.4
"2011","Sandwell 021","E02002063","Total",9172,4515,4657,9129,43,54,369.81,24.8
"2011","Sandwell 022","E02002064","Total",11970,5907,6063,11869,101,63,234.19,51.1
"2011","Sandwell 023","E02002065","Total",12146,6090,6056,12067,79,74,350.41,34.7
"2011","Sandwell 024","E02002066","Total",7211,3595,3616,7198,13,33,282.23,25.6
"2011","Sandwell 025","E02002067","Total",5508,2702,2806,5468,40,37,242.34,22.7
"2011","Sandwell 026","E02002068","Total",11983,5954,6029,11930,53,101,289.92,41.3
"2011","Sandwell 027","E02002069","Total",6567,3259,3308,6542,25,26,150.34,43.7
"2011","Sandwell 028","E02002070","Total",9140,4505,4635,8993,147,58,105.45,86.7
"2011","Sandwell 029","E02002071","Total",6507,3116,3391,6507,0,19,179.21,36.3
"2011","Sandwell 030","E02002072","Total",8346,4210,4136,8266,80,43,197.49,42.3
"2011","Sandwell 031","E02002073","Total",7550,3602,3948,7508,42,42,154.28,48.9
"2011","Sandwell 032","E02002074","Total",8026,3883,4143,7964,62,49,136.47,58.8
"2011","Sandwell 033","E02002075","Total",8539,4179,4360,8473,66,38,188.29,45.4
"2011","Sandwell 034","E02002076","Total",10306,5005,5301,10243,63,95,187.73,54.9
"2011","Sandwell 035","E02002077","Total",10182,5106,5076,10109,73,39,247.32,41.2
"2011","Sandwell 036","E02002078","Total",6205,2973,3232,6205,0,50,116.64,53.2
"2011","Sandwell 037","E02002079","Total",7985,3846,4139,7958,27,61,192.14,41.6
"2011","Sandwell 038","E02002080","Total",6664,3203,3461,6593,71,44,241.96,27.5
"2011","Sandwell 039","E02006810","Total",10032,4950,5082,9993,39,81,401.98,25.0
"2011","Solihull 001","E02002081","Total",5379,2599,2780,5366,13,54,186.52,28.8
"2011","Solihull 002","E02002082","Total",5909,2800,3109,5909,0,28,70.26,84.1
"2011","Solihull 003","E02002083","Total",5838,2884,2954,5825,13,53,134.42,43.4
"2011","Solihull 004","E02002084","Total",6183,2891,3292,6126,57,27,145.85,42.4
"2011","Solihull 005","E02002085","Total",6252,3028,3224,6252,0,38,146.35,42.7
"2011","Solihull 006","E02002086","Total",5443,2688,2755,5347,96,40,146.39,37.2
"2011","Solihull 007","E02002087","Total",6034,2883,3151,6032,2,12,120.46,50.1
"2011","Solihull 008","E02002088","Total",9327,4565,4762,9326,1,22,166.87,55.9
"2011","Solihull 009","E02002089","Total",7733,3769,3964,7532,201,56,1501.05,5.2
"2011","Solihull 010","E02002090","Total",5807,2835,2972,5807,0,48,122.07,47.6
"2011","Solihull 011","E02002091","Total",7277,3546,3731,7277,0,59,332.05,21.9
"2011","Solihull 012","E02002092","Total",7141,3451,3690,7086,55,72,167.68,42.6
"2011","Solihull 013","E02002093","Total",6557,3217,3340,6353,204,93,164.99,39.7
"2011","Solihull 014","E02002094","Total",5962,2873,3089,5866,96,138,225.55,26.4
"2011","Solihull 015","E02002095","Total",8537,4108,4429,8510,27,116,1510.50,5.7
"2011","Solihull 016","E02002096","Total",10008,4814,5194,9870,138,160,366.06,27.3
"2011","Solihull 017","E02002097","Total",6555,3220,3335,6497,58,145,4723.04,1.4
"2011","Solihull 018","E02002098","Total",9418,4561,4857,9381,37,148,218.03,43.2
"2011","Solihull 019","E02002099","Total",6561,3223,3338,6453,108,226,381.73,17.2
"2011","Solihull 021","E02002101","Total",5843,2781,3062,5783,60,54,134.40,43.5
"2011","Solihull 022","E02002102","Total",8592,4150,4442,8407,185,138,288.12,29.8
"2011","Solihull 023","E02002103","Total",6025,2857,3168,6012,13,85,156.32,38.5
"2011","Solihull 024","E02002104","Total",6166,2999,3167,6166,0,228,272.72,22.6
"2011","Solihull 025","E02002105","Total",7815,3851,3964,7811,4,201,2291.17,3.4
"2011","Solihull 026","E02002106","Total",9275,4445,4830,9127,148,280,897.36,10.3
"2011","Solihull 027","E02002107","Total",5783,2823,2960,5733,50,121,239.69,24.1
"2011","Solihull 028","E02002108","Total",9797,4798,4999,9790,7,320,890.01,11.0
"2011","Solihull 029","E02002109","Total",9357,4741,4616,9346,11,172,1688.95,5.5
"2011","Solihull 030","E02006808","Total",6100,2952,3148,6097,3,65,140.17,43.5
"2011","Walsall 001","E02002110","Total",6753,3307,3446,6692,61,48,503.10,13.4
"2011","Walsall 002","E02002111","Total",5923,2990,2933,5864,59,17,221.02,26.8
"2011","Walsall 003","E02002112","Total",5435,2692,2743,5435,0,58,242.70,22.4
"2011","Walsall 004","E02002113","Total",6468,3175,3293,6392,76,32,452.69,14.3
"2011","Walsall 005","E02002114","Total",6033,2940,3093,5974,59,59,179.75,33.6
"2011","Walsall 006","E02002115","Total",6564,3195,3369,6564,0,44,280.35,23.4
"2011","Walsall 007","E02002116","Total",6739,3285,3454,6720,19,81,330.67,20.4
"2011","Walsall 008","E02002117","Total",6051,2979,3072,5991,60,48,177.85,34.0
"2011","Walsall 009","E02002118","Total",7195,3444,3751,7194,1,35,179.35,40.1
"2011","Walsall 010","E02002119","Total",5990,2951,3039,5990,0,58,159.34,37.6
"2011","Walsall 011","E02002120","Total",6266,3069,3197,6261,5,56,116.64,53.7
"2011","Walsall 012","E02002121","Total",6211,3021,3190,6007,204,20,122.12,50.9
"2011","Walsall 013","E02002122","Total",5518,2744,2774,5481,37,18,158.63,34.8
"2011","Walsall 014","E02002123","Total",6431,3140,3291,6387,44,31,118.09,54.5
"2011","Walsall 015","E02002124","Total",6893,3297,3596,6827,66,76,575.34,12.0
"2011","Walsall 016","E02002125","Total",5918,2845,3073,5855,63,39,419.85,14.1
"2011","Walsall 017","E02002126","Total",6342,3145,3197,6342,0,17,208.86,30.4
"2011","Walsall 018","E02002127","Total",8331,4103,4228,8245,86,43,246.76,33.8
"2011","Walsall 019","E02002128","Total",5547,2697,2850,5542,5,33,203.21,27.3
"2011","Walsall 020","E02002129","Total",5902,2953,2949,5902,0,31,177.27,33.3
"2011","Walsall 021","E02002130","Total",6594,3227,3367,6586,8,24,164.33,40.1
"2011","Walsall 022","E02002131","Total",7847,3840,4007,7842,5,120,836.53,9.4
"2011","Walsall 023","E02002132","Total",6371,2964,3407,6320,51,17,142.11,44.8
"2011","Walsall 024","E02002133","Total",6645,3376,3269,6580,65,84,351.35,18.9
"2011","Walsall 025","E02002134","Total",8221,3982,4239,8159,62,40,254.42,32.3
"2011","Walsall 026","E02002135","Total",7081,3513,3568,7064,17,44,216.58,32.7
"2011","Walsall 027","E02002136","Total",7562,3736,3826,7530,32,42,226.24,33.4
"2011","Walsall 028","E02002137","Total",6285,3089,3196,6251,34,91,215.43,29.2
"2011","Walsall 029","E02002138","Total",6303,3125,3178,6278,25,77,180.24,35.0
"2011","Walsall 030","E02002139","Total",9498,4880,4618,9027,471,109,236.81,40.1
"2011","Walsall 031","E02002140","Total",8021,3979,4042,7940,81,47,192.57,41.7
"2011","Walsall 032","E02002141","Total",6690,3252,3438,6690,0,86,266.25,25.1
"2011","Walsall 033","E02002142","Total",6793,3370,3423,6694,99,35,268.77,25.3
"2011","Walsall 034","E02002143","Total",10027,4992,5035,9991,36,61,164.42,61.0
"2011","Walsall 035","E02002144","Total",6703,3292,3411,6703,0,118,281.85,23.8
"2011","Walsall 036","E02002145","Total",6799,3351,3448,6790,9,38,126.33,53.8
"2011","Walsall 037","E02002146","Total",6505,3151,3354,6439,66,30,203.19,32.0
"2011","Walsall 038","E02002147","Total",7858,3901,3957,7842,16,24,236.00,33.3
"2011","Walsall 039","E02002148","Total",11010,5327,5683,11006,4,120,758.48,14.5
"2011","Wolverhampton 001","E02002149","Total",10027,4846,5181,9973,54,66,358.73,28.0
"2011","Wolverhampton 002","E02002150","Total",5715,2749,2966,5668,47,58,202.96,28.2
"2011","Wolverhampton 003","E02002151","Total",5826,2806,3020,5804,22,41,112.23,51.9
"2011","Wolverhampton 004","E02002152","Total",6232,2967,3265,6160,72,28,170.13,36.6
"2011","Wolverhampton 005","E02002153","Total",7502,3695,3807,7502,0,33,150.61,49.8
"2011","Wolverhampton 006","E02002154","Total",5580,2677,2903,5549,31,34,234.38,23.8
"2011","Wolverhampton 007","E02002155","Total",5829,2707,3122,5825,4,25,102.98,56.6
"2011","Wolverhampton 008","E02002156","Total",8365,4016,4349,8359,6,67,157.08,53.3
"2011","Wolverhampton 009","E02002157","Total",7742,3791,3951,7660,82,89,321.03,24.1
"2011","Wolverhampton 010","E02002158","Total",7659,3776,3883,7601,58,42,163.61,46.8
"2011","Wolverhampton 011","E02002159","Total",6023,2929,3094,5992,31,28,117.20,51.4
"2011","Wolverhampton 012","E02002160","Total",7048,3478,3570,6950,98,32,330.97,21.3
"2011","Wolverhampton 013","E02002161","Total",6288,3201,3087,6279,9,50,200.12,31.4
"2011","Wolverhampton 014","E02002162","Total",7556,3610,3946,7340,216,130,295.64,25.6
"2011","Wolverhampton 015","E02002163","Total",11250,5829,5421,11211,39,80,232.18,48.5
"2011","Wolverhampton 016","E02002164","Total",6843,3739,3104,6029,814,74,71.85,95.2
"2011","Wolverhampton 017","E02002165","Total",7729,4224,3505,7499,230,85,163.68,47.2
"2011","Wolverhampton 018","E02002166","Total",9056,4467,4589,8996,60,49,282.99,32.0
"2011","Wolverhampton 019","E02002167","Total",6548,3215,3333,6548,0,82,259.14,25.3
"2011","Wolverhampton 020","E02002168","Total",10321,5333,4988,9528,793,75,306.01,33.7
"2011","Wolverhampton 021","E02002169","Total",8647,4193,4454,8395,252,154,291.52,29.7
"2011","Wolverhampton 022","E02002170","Total",6253,3007,3246,6253,0,33,115.46,54.2
"2011","Wolverhampton 023","E02002171","Total",7367,3688,3679,7367,0,28,180.10,40.9
"2011","Wolverhampton 026","E02002174","Total",7578,3719,3859,7450,128,121,173.61,43.6
"2011","Wolverhampton 027","E02002175","Total",7031,3477,3554,6970,61,33,221.72,31.7
"2011","Wolverhampton 028","E02002176","Total",7692,3747,3945,7673,19,63,149.12,51.6
"2011","Wolverhampton 029","E02002177","Total",9032,4503,4529,8947,85,56,335.86,26.9
"2011","Wolverhampton 030","E02002178","Total",8114,4026,4088,7875,239,116,236.67,34.3
"2011","Wolverhampton 031","E02002179","Total",6401,3118,3283,6328,73,61,159.02,40.3
"2011","Wolverhampton 032","E02002180","Total",6392,3113,3279,6367,25,50,175.40,36.4
"2011","Wolverhampton 033","E02002181","Total",7079,3487,3592,7066,13,32,215.85,32.8
"2011","Wolverhampton 034","E02002182","Total",6645,3231,3414,6550,95,47,152.01,43.7
"2011","Wolverhampton 035","E02006894","Total",12100,6077,6023,11812,288,94,304.09,39.8
"2011","Bromsgrove 001","E02006696","Total",6270,3022,3248,6187,83,160,946.73,6.6
"2011","Bromsgrove 002","E02006697","Total",7266,3623,3643,7054,212,151,6559.68,1.1
"2011","Bromsgrove 003","E02006698","Total",6491,3202,3289,6461,30,74,504.53,12.9
"2011","Bromsgrove 004","E02006699","Total",5939,2886,3053,5924,15,77,219.86,27.0
"2011","Bromsgrove 005","E02006700","Total",5739,2782,2957,5536,203,90,1710.48,3.4
"2011","Bromsgrove 006","E02006701","Total",6033,2956,3077,5880,153,167,1163.20,5.2
"2011","Bromsgrove 007","E02006702","Total",5808,2849,2959,5755,53,53,247.51,23.5
"2011","Bromsgrove 008","E02006703","Total",7174,3532,3642,7075,99,109,992.28,7.2
"2011","Bromsgrove 009","E02006704","Total",6564,3193,3371,6394,170,106,3870.45,1.7
"2011","Bromsgrove 010","E02006705","Total",6696,3242,3454,6593,103,79,201.72,33.2
"2011","Bromsgrove 011","E02006706","Total",6804,3290,3514,6281,523,102,280.68,24.2
"2011","Bromsgrove 012","E02006707","Total",6867,3317,3550,6828,39,122,275.10,25.0
"2011","Bromsgrove 013","E02006708","Total",8102,3950,4152,8077,25,66,210.27,38.5
"2011","Bromsgrove 014","E02006709","Total",7884,4456,3428,6788,1096,134,4514.42,1.7
"2011","Malvern Hills 001","E02006710","Total",7867,3887,3980,7732,135,140,15169.00,0.5
"2011","Malvern Hills 002","E02006711","Total",7847,3886,3961,7659,188,176,11406.76,0.7
"2011","Malvern Hills 003","E02006712","Total",6929,3450,3479,6828,101,150,7410.05,0.9
"2011","Malvern Hills 004","E02006713","Total",6155,2933,3222,6081,74,93,439.41,14.0
"2011","Malvern Hills 005","E02006714","Total",5262,2560,2702,5155,107,119,5670.88,0.9
"2011","Malvern Hills 006","E02006715","Total",8223,4080,4143,8052,171,124,875.92,9.4
"2011","Malvern Hills 007","E02006716","Total",6425,3106,3319,6417,8,66,260.78,24.6
"2011","Malvern Hills 008","E02006717","Total",5691,2712,2979,5572,119,109,4992.20,1.1
"2011","Malvern Hills 009","E02006718","Total",6131,2810,3321,5784,347,93,440.44,13.9
"2011","Malvern Hills 010","E02006719","Total",7273,3604,3669,6546,727,170,1286.35,5.7
"2011","Malvern Hills 011","E02006720","Total",6828,3308,3520,6596,232,152,9755.34,0.7
"2011","Redditch 001","E02006721","Total",5705,2822,2883,5686,19,62,384.05,14.9
"2011","Redditch 002","E02006722","Total",5489,2702,2787,5473,16,17,127.78,43.0
"2011","Redditch 003","E02006723","Total",8282,4030,4252,8150,132,56,251.24,33.0
"2011","Redditch 004","E02006724","Total",6878,3600,3278,6867,11,37,215.12,32.0
"2011","Redditch 005","E02006725","Total",5662,2836,2826,5655,7,49,154.94,36.5
"2011","Redditch 006","E02006726","Total",6411,3247,3164,6385,26,61,263.27,24.4
"2011","Redditch 007","E02006727","Total",6083,3060,3023,6083,0,55,341.60,17.8
"2011","Redditch 008","E02006728","Total",7060,3404,3656,6898,162,118,378.33,18.7
"2011","Redditch 009","E02006729","Total",7282,3657,3625,7242,40,67,343.00,21.2
"2011","Redditch 010","E02006730","Total",6188,3081,3107,6188,0,41,157.04,39.4
"2011","Redditch 011","E02006731","Total",5829,2788,3041,5810,19,69,208.15,28.0
"2011","Redditch 012","E02006732","Total",7293,3639,3654,7284,9,95,190.73,38.2
"2011","Redditch 013","E02006733","Total",6052,2982,3070,6024,28,96,2409.73,2.5
"2011","Worcester 001","E02006734","Total",8175,3991,4184,8056,119,99,453.14,18.0
"2011","Worcester 002","E02006735","Total",5205,2516,2689,5157,48,22,85.75,60.7
"2011","Worcester 003","E02006736","Total",6734,3356,3378,6734,0,74,360.49,18.7
"2011","Worcester 004","E02006737","Total",7803,3798,4005,7781,22,106,192.43,40.5
"2011","Worcester 005","E02006738","Total",8966,4427,4539,8961,5,49,178.79,50.1
"2011","Worcester 006","E02006739","Total",5912,2820,3092,5012,900,109,163.72,36.1
"2011","Worcester 007","E02006740","Total",6979,3556,3423,6689,290,80,190.61,36.6
"2011","Worcester 008","E02006741","Total",5639,2742,2897,5639,0,67,229.37,24.6
"2011","Worcester 009","E02006742","Total",8420,4128,4292,8400,20,73,175.72,47.9
"2011","Worcester 010","E02006743","Total",6560,3210,3350,6522,38,38,216.70,30.3
"2011","Worcester 011","E02006744","Total",7015,3591,3424,6850,165,74,162.02,43.3
"2011","Worcester 012","E02006745","Total",7890,3883,4007,7768,122,108,430.88,18.3
"2011","Worcester 013","E02006746","Total",7619,3730,3889,7444,175,108,296.37,25.7
"2011","Worcester 014","E02006747","Total",5851,2815,3036,5841,10,87,191.92,30.5
"2011","Wychavon 001","E02006748","Total",6662,3279,3383,6546,116,115,7778.76,0.9
"2011","Wychavon 002","E02006749","Total",5384,2585,2799,5377,7,45,238.75,22.6
"2011","Wychavon 003","E02006750","Total",5430,2611,2819,5354,76,55,224.10,24.2
"2011","Wychavon 004","E02006751","Total",5927,2822,3105,5833,94,72,150.03,39.5
"2011","Wychavon 005","E02006752","Total",6763,3323,3440,6725,38,143,223.69,30.2
"2011","Wychavon 006","E02006753","Total",6301,3172,3129,6263,38,125,4644.20,1.4
"2011","Wychavon 007","E02006754","Total",5475,2705,2770,5475,0,127,9966.50,0.5
"2011","Wychavon 008","E02006755","Total",5374,2673,2701,5331,43,134,8269.86,0.6
"2011","Wychavon 009","E02006756","Total",5366,2595,2771,5285,81,94,3993.34,1.3
"2011","Wychavon 010","E02006757","Total",6840,3355,3485,6677,163,128,7314.43,0.9
"2011","Wychavon 011","E02006758","Total",5628,2959,2669,5228,400,94,4420.46,1.3
"2011","Wychavon 012","E02006759","Total",7065,3438,3627,7001,64,77,1142.25,6.2
"2011","Wychavon 013","E02006760","Total",7923,3887,4036,7857,66,109,3551.61,2.2
"2011","Wychavon 014","E02006761","Total",5833,2886,2947,5786,47,38,217.51,26.8
"2011","Wychavon 015","E02006762","Total",5713,2793,2920,5695,18,74,765.72,7.5
"2011","Wychavon 016","E02006763","Total",6467,3202,3265,6407,60,96,456.61,14.2
"2011","Wychavon 017","E02006764","Total",5415,2662,2753,5392,23,55,161.48,33.5
"2011","Wychavon 018","E02006765","Total",5872,2810,3062,5808,64,112,4739.63,1.2
"2011","Wychavon 019","E02006766","Total",7506,3688,3818,7505,1,181,8095.19,0.9
"2011","Wyre Forest 001","E02006767","Total",8848,4448,4400,8584,264,130,7447.78,1.2
"2011","Wyre Forest 002","E02006768","Total",6790,3333,3457,6754,36,57,184.59,36.8
"2011","Wyre Forest 003","E02006769","Total",7171,3521,3650,7096,75,77,191.49,37.4
"2011","Wyre Forest 004","E02006770","Total",7166,3562,3604,7088,78,53,233.99,30.6
"2011","Wyre Forest 005","E02006771","Total",6576,3248,3328,6515,61,111,3823.38,1.7
"2011","Wyre Forest 006","E02006772","Total",6445,3118,3327,6316,129,76,188.34,34.2
"2011","Wyre Forest 007","E02006773","Total",8301,4017,4284,8182,119,76,295.69,28.1
"2011","Wyre Forest 008","E02006774","Total",7482,3737,3745,7455,27,55,200.33,37.3
"2011","Wyre Forest 009","E02006775","Total",5164,2590,2574,5144,20,28,299.88,17.2
"2011","Wyre Forest 010","E02006776","Total",6579,3259,3320,6546,33,96,306.20,21.5
"2011","Wyre Forest 011","E02006777","Total",7161,3551,3610,7099,62,120,5066.08,1.4
"2011","Wyre Forest 012","E02006778","Total",6879,3280,3599,6783,96,61,485.84,14.2
"2011","Wyre Forest 013","E02006779","Total",7622,3806,3816,7614,8,58,531.69,14.3
"2011","Wyre Forest 014","E02006780","Total",5791,2829,2962,5782,9,44,285.38,20.3
"2011","Bedford 001","E02003616","Total",5675,2773,2902,5615,60,188,10357.40,0.5
"2011","Bedford 002","E02003617","Total",8947,4429,4518,8854,93,203,11454.33,0.8
"2011","Bedford 003","E02003618","Total",8768,4213,4555,8556,212,155,4370.81,2.0
"2011","Bedford 004","E02003619","Total",10034,4907,5127,9908,126,178,11449.31,0.9
"2011","Bedford 005","E02003620","Total",8153,3981,4172,8125,28,157,226.44,36.0
"2011","Bedford 006","E02003621","Total",8072,3932,4140,8048,24,132,242.90,33.2
"2011","Bedford 007","E02003622","Total",9090,4327,4763,9090,0,88,244.53,37.2
"2011","Bedford 008","E02003623","Total",8144,3992,4152,8120,24,236,1350.70,6.0
"2011","Bedford 009","E02003624","Total",6008,3076,2932,4808,1200,139,175.12,34.3
"2011","Bedford 010","E02003625","Total",8248,4251,3997,7574,674,84,237.33,34.8
"2011","Bedford 011","E02003626","Total",5395,2621,2774,5388,7,79,351.96,15.3
"2011","Bedford 012","E02003627","Total",9069,4609,4460,8822,247,128,162.18,55.9
"2011","Bedford 013","E02003628","Total",8552,4292,4260,8526,26,115,183.51,46.6
"2011","Bedford 014","E02003629","Total",9468,4597,4871,9418,50,59,422.58,22.4
"2011","Bedford 015","E02003630","Total",9681,4727,4954,9680,1,69,225.66,42.9
"2011","Bedford 016","E02003631","Total",5475,2659,2816,5410,65,65,188.26,29.1
"2011","Bedford 017","E02003632","Total",6061,2943,3118,6028,33,63,97.54,62.1
"2011","Bedford 018","E02003633","Total",7794,3786,4008,7761,33,79,635.67,12.3
"2011","Bedford 019","E02003634","Total",9499,4561,4938,9460,39,102,3631.94,2.6
"2011","Bedford 020","E02003635","Total",5346,2636,2710,5345,1,73,1633.03,3.3
"2011","Central Bedfordshire 001","E02003599","Total",5601,2832,2769,5600,1,50,110.04,50.9
"2011","Central Bedfordshire 002","E02003600","Total",6056,2991,3065,5984,72,66,1654.70,3.7
"2011","Central Bedfordshire 003","E02003601","Total",7199,3555,3644,7193,6,113,6268.60,1.1
"2011","Central Bedfordshire 004","E02003602","Total",5946,2972,2974,5907,39,89,7647.74,0.8
"2011","Central Bedfordshire 005","E02003603","Total",9611,4760,4851,9555,56,66,610.63,15.7
"2011","Central Bedfordshire 006","E02003604","Total",6940,3376,3564,6896,44,95,1273.07,5.5
"2011","Central Bedfordshire 007","E02003605","Total",8312,4369,3943,7750,562,143,4078.95,2.0
"2011","Central Bedfordshire 008","E02003606","Total",7583,3737,3846,7578,5,160,4285.46,1.8
"2011","Central Bedfordshire 009","E02003607","Total",8487,4174,4313,8423,64,114,7581.85,1.1
"2011","Central Bedfordshire 010","E02003608","Total",10928,5407,5521,10835,93,127,2364.21,4.6
"2011","Central Bedfordshire 011","E02003609","Total",10017,4996,5021,9782,235,150,3944.94,2.5
"2011","Central Bedfordshire 012","E02003610","Total",7175,3533,3642,7143,32,147,1493.10,4.8
"2011","Central Bedfordshire 013","E02003611","Total",8480,4224,4256,8245,235,151,2401.05,3.5
"2011","Central Bedfordshire 014","E02003612","Total",9632,4735,4897,9632,0,95,1162.80,8.3
"2011","Central Bedfordshire 015","E02003613","Total",5861,2942,2919,5828,33,90,369.74,15.9
"2011","Central Bedfordshire 016","E02003614","Total",7373,3700,3673,7347,26,145,1053.32,7.0
"2011","Central Bedfordshire 017","E02003615","Total",8788,4397,4391,8752,36,200,3984.47,2.2
"2011","Central Bedfordshire 018","E02003636","Total",7312,3610,3702,7296,16,151,3405.21,2.1
"2011","Central Bedfordshire 019","E02003637","Total",9389,4697,4692,9349,40,164,6588.65,1.4
"2011","Central Bedfordshire 020","E02003638","Total",7501,3713,3788,7399,102,116,425.58,17.6
"2011","Central Bedfordshire 021","E02003639","Total",8645,4158,4487,8549,96,85,177.68,48.7
"2011","Central Bedfordshire 022","E02003640","Total",6010,3018,2992,5948,62,98,401.61,15.0
"2011","Central Bedfordshire 023","E02003641","Total",5474,2718,2756,5474,0,124,209.54,26.1
"2011","Central Bedfordshire 025","E02003642","Total",8796,4358,4438,8789,7,57,412.47,21.3
"2011","Central Bedfordshire 024","E02003643","Total",9839,4910,4929,9839,0,111,472.63,20.8
"2011","Central Bedfordshire 026","E02003644","Total",8487,4098,4389,8388,99,72,838.24,10.1
"2011","Central Bedfordshire 027","E02003645","Total",6746,3337,3409,6675,71,96,222.22,30.4
"2011","Central Bedfordshire 028","E02003646","Total",8865,4370,4495,8830,35,81,242.16,36.6
"2011","Central Bedfordshire 029","E02003647","Total",8574,4215,4359,8477,97,106,201.49,42.6
"2011","Central Bedfordshire 030","E02003648","Total",5193,2526,2667,5184,9,47,122.92,42.2
"2011","Central Bedfordshire 031","E02003649","Total",6875,3392,3483,6851,24,115,128.26,53.6
"2011","Central Bedfordshire 032","E02003650","Total",6760,3328,3432,6730,30,120,4310.15,1.6
"2011","Central Bedfordshire 033","E02003651","Total",5926,2896,3030,5892,34,85,3122.97,1.9
"2011","Luton 001","E02003258","Total",8486,4208,4278,8461,25,146,208.64,40.7
"2011","Luton 002","E02003259","Total",6431,3221,3210,6415,16,67,184.60,34.8
"2011","Luton 003","E02003260","Total",8392,3994,4398,8392,0,73,119.45,70.3
"2011","Luton 004","E02003261","Total",6039,2884,3155,5959,80,100,127.10,47.5
"2011","Luton 005","E02003262","Total",9812,4686,5126,9687,125,105,180.33,54.4
"2011","Luton 006","E02003263","Total",11760,5793,5967,11597,163,162,200.74,58.6
"2011","Luton 007","E02003264","Total",9326,4524,4802,9266,60,208,225.39,41.4
"2011","Luton 008","E02003265","Total",8233,4049,4184,8233,0,100,287.04,28.7
"2011","Luton 009","E02003266","Total",9268,4445,4823,9258,10,73,167.23,55.4
"2011","Luton 010","E02003267","Total",13253,6688,6565,13242,11,119,138.37,95.8
"2011","Luton 011","E02003268","Total",10907,5440,5467,10764,143,93,168.71,64.6
"2011","Luton 012","E02003269","Total",9985,4949,5036,9964,21,101,243.49,41.0
"2011","Luton 013","E02003270","Total",8000,3942,4058,7992,8,93,162.99,49.1
"2011","Luton 014","E02003271","Total",9775,4838,4937,9771,4,131,554.22,17.6
"2011","Luton 015","E02003272","Total",10490,5362,5128,10476,14,84,139.17,75.4
"2011","Luton 016","E02003273","Total",10286,5064,5222,10267,19,118,253.00,40.7
"2011","Luton 017","E02003274","Total",10849,5646,5203,10692,157,75,91.77,118.2
"2011","Luton 018","E02003275","Total",11733,6410,5323,11262,471,119,198.68,59.1
"2011","Luton 019","E02003276","Total",8445,4511,3934,8364,81,67,152.57,55.4
"2011","Luton 020","E02003277","Total",10190,4980,5210,10142,48,93,258.98,39.3
"2011","Luton 021","E02003278","Total",11541,6320,5221,11345,196,105,272.86,42.3
"2011","Peterborough 001","E02003237","Total",6216,3055,3161,6184,32,122,2584.06,2.4
"2011","Peterborough 002","E02003238","Total",5927,2890,3037,5927,0,90,198.93,29.8
"2011","Peterborough 003","E02003239","Total",7898,3941,3957,7815,83,112,4148.53,1.9
"2011","Peterborough 004","E02003240","Total",6629,3461,3168,6149,480,147,6869.01,1.0
"2011","Peterborough 005","E02003241","Total",6138,2957,3181,6123,15,46,9535.52,0.6
"2011","Peterborough 006","E02003242","Total",7925,3832,4093,7920,5,82,299.04,26.5
"2011","Peterborough 007","E02003243","Total",9741,4746,4995,9694,47,56,361.61,26.9
"2011","Peterborough 008","E02003244","Total",8826,4278,4548,8800,26,51,198.30,44.5
"2011","Peterborough 009","E02003245","Total",7658,3739,3919,7658,0,55,208.00,36.8
"2011","Peterborough 010","E02003246","Total",9097,4695,4402,8863,234,73,242.02,37.6
"2011","Peterborough 011","E02003247","Total",7862,3842,4020,7799,63,92,204.05,38.5
"2011","Peterborough 012","E02003248","Total",10337,5132,5205,10161,176,134,188.84,54.7
"2011","Peterborough 013","E02003249","Total",10563,5264,5299,10529,34,87,872.27,12.1
"2011","Peterborough 014","E02003250","Total",10022,5245,4777,9924,98,78,217.55,46.1
"2011","Peterborough 015","E02003251","Total",7118,3474,3644,6981,137,165,569.37,12.5
"2011","Peterborough 016","E02003252","Total",10250,5124,5126,10161,89,106,247.45,41.4
"2011","Peterborough 017","E02003253","Total",8392,4124,4268,8302,90,60,271.00,31.0
"2011","Peterborough 018","E02003254","Total",8646,4207,4439,8646,0,190,4020.38,2.2
"2011","Peterborough 019","E02003255","Total",8807,4343,4464,8807,0,68,1013.83,8.7
"2011","Peterborough 021","E02003257","Total",8626,4166,4460,8622,4,48,250.90,34.4
"2011","Peterborough 022","E02006877","Total",7901,3830,4071,7784,117,100,707.95,11.2
"2011","Peterborough 023","E02006878","Total",9052,4514,4538,8978,74,78,1129.21,8.0
"2011","Southend-on-Sea 001","E02003279","Total",9364,4565,4799,9310,54,83,223.87,41.8
"2011","Southend-on-Sea 002","E02003280","Total",9726,4739,4987,9715,11,102,294.08,33.1
"2011","Southend-on-Sea 003","E02003281","Total",9219,4424,4795,9173,46,92,263.71,35.0
"2011","Southend-on-Sea 004","E02003282","Total",9971,4920,5051,9852,119,102,248.45,40.1
"2011","Southend-on-Sea 005","E02003283","Total",10475,5063,5412,10423,52,112,226.48,46.3
"2011","Southend-on-Sea 006","E02003284","Total",11213,5513,5700,11196,17,81,351.32,31.9
"2011","Southend-on-Sea 007","E02003285","Total",10847,5400,5447,10802,45,104,91.71,118.3
"2011","Southend-on-Sea 008","E02003286","Total",9154,4472,4682,9102,52,182,305.87,29.9
"2011","Southend-on-Sea 009","E02003287","Total",9710,4653,5057,9631,79,121,465.32,20.9
"2011","Southend-on-Sea 010","E02003288","Total",11004,5525,5479,10877,127,57,160.83,68.4
"2011","Southend-on-Sea 011","E02003289","Total",10083,4892,5191,10014,69,103,151.29,66.6
"2011","Southend-on-Sea 012","E02003290","Total",10045,4982,5063,9378,667,133,162.05,62.0
"2011","Southend-on-Sea 013","E02003291","Total",11159,5390,5769,11143,16,87,380.67,29.3
"2011","Southend-on-Sea 014","E02003292","Total",11130,5515,5615,10984,146,87,124.65,89.3
"2011","Southend-on-Sea 015","E02003293","Total",11063,5612,5451,10559,504,94,164.05,67.4
"2011","Southend-on-Sea 016","E02003294","Total",9215,4443,4772,9170,45,171,274.50,33.6
"2011","Southend-on-Sea 017","E02003295","Total",10280,4929,5351,10160,120,141,286.75,35.9
"2011","Thurrock 001","E02003296","Total",7040,3491,3549,7038,2,73,2061.43,3.4
"2011","Thurrock 002","E02003297","Total",7213,3418,3795,7166,47,59,200.14,36.0
"2011","Thurrock 003","E02003298","Total",7060,3397,3663,7039,21,68,178.40,39.6
"2011","Thurrock 004","E02003299","Total",6115,2986,3129,6063,52,96,4725.69,1.3
"2011","Thurrock 005","E02003300","Total",7658,3797,3861,7652,6,66,653.62,11.7
"2011","Thurrock 006","E02003301","Total",9486,4662,4824,9470,16,62,1470.62,6.5
"2011","Thurrock 007","E02003302","Total",9974,4972,5002,9932,42,59,309.55,32.2
"2011","Thurrock 008","E02003303","Total",7736,3812,3924,7735,1,47,884.70,8.7
"2011","Thurrock 009","E02003304","Total",9314,4594,4720,9307,7,101,350.06,26.6
"2011","Thurrock 010","E02003305","Total",5770,2858,2912,5760,10,58,216.20,26.7
"2011","Thurrock 012","E02003307","Total",9865,4742,5123,9745,120,49,364.10,27.1
"2011","Thurrock 013","E02003308","Total",6364,3107,3257,6339,25,60,1725.46,3.7
"2011","Thurrock 014","E02003309","Total",7425,3677,3748,7420,5,80,200.85,37.0
"2011","Thurrock 015","E02003310","Total",11654,5915,5739,11641,13,69,1176.37,9.9
"2011","Thurrock 016","E02003311","Total",8435,4217,4218,8255,180,72,208.20,40.5
"2011","Thurrock 017","E02003312","Total",8086,4163,3923,8086,0,44,109.10,74.1
"2011","Thurrock 018","E02003313","Total",13055,6320,6735,12989,66,86,1129.55,11.6
"2011","Thurrock 019","E02006859","Total",7384,3646,3738,7378,6,72,139.93,52.8
"2011","Thurrock 020","E02006926","Total",8071,4049,4022,8057,14,81,233.63,34.5
"2011","Cambridge 001","E02003719","Total",9142,4644,4498,8992,150,86,157.07,58.2
"2011","Cambridge 002","E02003720","Total",9070,4607,4463,8916,154,115,149.38,60.7
"2011","Cambridge 003","E02003721","Total",9405,4731,4674,9239,166,96,261.39,36.0
"2011","Cambridge 004","E02003722","Total",8629,4424,4205,8331,298,180,152.56,56.6
"2011","Cambridge 005","E02003723","Total",9785,5165,4620,4529,5256,194,341.05,28.7
"2011","Cambridge 006","E02003724","Total",9907,5104,4803,9861,46,93,394.60,25.1
"2011","Cambridge 007","E02003725","Total",15017,7933,7084,7235,7782,309,613.96,24.5
"2011","Cambridge 008","E02003726","Total",8333,4277,4056,7564,769,149,105.41,79.1
"2011","Cambridge 009","E02003727","Total",9252,4704,4548,9206,46,79,148.81,62.2
"2011","Cambridge 010","E02003728","Total",9386,4770,4616,8977,409,119,193.04,48.6
"2011","Cambridge 011","E02003729","Total",8780,4293,4487,8780,0,127,368.14,23.8
"2011","Cambridge 012","E02003730","Total",8034,3979,4055,7415,619,202,732.64,11.0
"2011","Cambridge 013","E02003731","Total",9127,4353,4774,8300,827,264,451.89,20.2
"2011","East Cambridgeshire 001","E02003732","Total",8738,4329,4409,8617,121,62,7401.01,1.2
"2011","East Cambridgeshire 002","E02003733","Total",8376,4140,4236,8352,24,102,10368.07,0.8
"2011","East Cambridgeshire 003","E02003734","Total",11773,5754,6019,11658,115,128,1046.80,11.2
"2011","East Cambridgeshire 004","E02003735","Total",8483,4188,4295,8243,240,103,4875.59,1.7
"2011","East Cambridgeshire 005","E02003736","Total",9900,4975,4925,9886,14,148,8984.48,1.1
"2011","East Cambridgeshire 006","E02003737","Total",11699,5875,5824,11668,31,114,6864.22,1.7
"2011","East Cambridgeshire 007","E02003738","Total",6146,3036,3110,6146,0,108,6914.41,0.9
"2011","East Cambridgeshire 008","E02003739","Total",6309,3084,3225,6296,13,100,2562.99,2.5
"2011","East Cambridgeshire 009","E02003740","Total",6039,2907,3132,5846,193,119,8435.18,0.7
"2011","East Cambridgeshire 011","E02006825","Total",6355,3155,3200,6344,11,101,7675.46,0.8
"2011","Fenland 001","E02003742","Total",6305,3114,3191,6284,21,52,5103.27,1.2
"2011","Fenland 002","E02003743","Total",10173,5007,5166,9997,176,72,258.56,39.3
"2011","Fenland 003","E02003744","Total",12668,6178,6490,12469,199,97,1609.98,7.9
"2011","Fenland 004","E02003745","Total",9690,4766,4924,9606,84,102,14730.24,0.7
"2011","Fenland 005","E02003746","Total",7835,4079,3756,7342,493,61,2939.80,2.7
"2011","Fenland 006","E02003747","Total",11197,5396,5801,11097,100,118,1079.10,10.4
"2011","Fenland 007","E02003748","Total",7430,3581,3849,7410,20,34,1527.04,4.9
"2011","Fenland 008","E02003749","Total",5998,2983,3015,5998,0,80,9262.67,0.6
"2011","Fenland 009","E02003750","Total",7033,3366,3667,6850,183,72,3320.95,2.1
"2011","Fenland 010","E02003751","Total",6480,3178,3302,6467,13,55,8695.39,0.7
"2011","Fenland 011","E02003752","Total",10453,5163,5290,10414,39,100,6117.96,1.7
"2011","Huntingdonshire 001","E02003753","Total",11041,5400,5641,10997,44,121,3175.10,3.5
"2011","Huntingdonshire 002","E02003754","Total",5758,2844,2914,5749,9,107,8188.97,0.7
"2011","Huntingdonshire 003","E02003755","Total",8479,4231,4248,8447,32,112,6438.71,1.3
"2011","Huntingdonshire 004","E02003756","Total",6536,3246,3290,6436,100,82,8787.26,0.7
"2011","Huntingdonshire 005","E02003757","Total",6354,3140,3214,6298,56,119,4999.55,1.3
"2011","Huntingdonshire 006","E02003758","Total",9375,4662,4713,9286,89,136,13195.03,0.7
"2011","Huntingdonshire 007","E02003759","Total",6126,3095,3031,6108,18,128,2568.58,2.4
"2011","Huntingdonshire 008","E02003760","Total",8377,4137,4240,8357,20,54,346.26,24.2
"2011","Huntingdonshire 009","E02003761","Total",5957,2902,3055,5824,133,48,179.87,33.1
"2011","Huntingdonshire 010","E02003762","Total",8571,4273,4298,8177,394,183,5268.86,1.6
"2011","Huntingdonshire 011","E02003763","Total",9869,4859,5010,9863,6,155,519.74,19.0
"2011","Huntingdonshire 012","E02003764","Total",9398,4682,4716,9300,98,125,465.88,20.2
"2011","Huntingdonshire 013","E02003765","Total",6515,3245,3270,6481,34,90,420.89,15.5
"2011","Huntingdonshire 014","E02003766","Total",6711,3275,3436,6711,0,114,1984.13,3.4
"2011","Huntingdonshire 015","E02003767","Total",6528,3238,3290,6459,69,163,16539.19,0.4
"2011","Huntingdonshire 016","E02003768","Total",9278,4526,4752,9273,5,186,3940.75,2.4
"2011","Huntingdonshire 017","E02003769","Total",7433,4241,3192,6257,1176,133,4765.88,1.6
"2011","Huntingdonshire 018","E02003770","Total",7934,3909,4025,7872,62,122,7744.92,1.0
"2011","Huntingdonshire 019","E02003771","Total",6272,3098,3174,6225,47,66,328.03,19.1
"2011","Huntingdonshire 020","E02003772","Total",6815,3407,3408,6772,43,122,254.90,26.7
"2011","Huntingdonshire 021","E02003773","Total",10477,5263,5214,10418,59,90,297.33,35.2
"2011","Huntingdonshire 022","E02003774","Total",5704,2859,2845,5642,62,41,208.48,27.4
"2011","South Cambridgeshire 001","E02003775","Total",6877,3402,3475,6875,2,128,3389.94,2.0
"2011","South Cambridgeshire 002","E02003776","Total",6543,3181,3362,6457,86,122,3480.94,1.9
"2011","South Cambridgeshire 003","E02003777","Total",6647,3347,3300,6646,1,106,3621.27,1.8
"2011","South Cambridgeshire 004","E02003778","Total",6014,3229,2785,5515,499,76,3260.03,1.8
"2011","South Cambridgeshire 005","E02003779","Total",5048,2519,2529,5040,8,97,2479.83,2.0
"2011","South Cambridgeshire 006","E02003780","Total",10600,5217,5383,10444,156,198,1448.14,7.3
"2011","South Cambridgeshire 007","E02003781","Total",6361,3195,3166,6321,40,109,2830.11,2.2
"2011","South Cambridgeshire 009","E02003783","Total",7065,3479,3586,6571,494,176,3174.83,2.2
"2011","South Cambridgeshire 010","E02003784","Total",8643,4237,4406,8641,2,201,4896.58,1.8
"2011","South Cambridgeshire 011","E02003785","Total",8695,4320,4375,8572,123,135,4603.11,1.9
"2011","South Cambridgeshire 012","E02003786","Total",6104,2982,3122,6089,15,135,1579.98,3.9
"2011","South Cambridgeshire 013","E02003787","Total",7229,3552,3677,7228,1,142,8110.44,0.9
"2011","South Cambridgeshire 014","E02003788","Total",6359,3176,3183,6359,0,160,3756.62,1.7
"2011","South Cambridgeshire 015","E02003789","Total",7145,3531,3614,7106,39,105,771.42,9.3
"2011","South Cambridgeshire 016","E02003790","Total",9528,4656,4872,9426,102,237,12166.64,0.8
"2011","South Cambridgeshire 017","E02003791","Total",7816,3861,3955,7813,3,210,7583.97,1.0
"2011","South Cambridgeshire 018","E02003792","Total",9367,4577,4790,9222,145,206,6411.19,1.5
"2011","South Cambridgeshire 019","E02003793","Total",7492,3770,3722,7250,242,154,7549.56,1.0
"2011","South Cambridgeshire 020","E02006873","Total",7185,3582,3603,7185,0,70,641.02,11.2
"2011","South Cambridgeshire 021","E02006874","Total",8037,3977,4060,8019,18,147,8407.15,1.0
"2011","Basildon 001","E02004424","Total",7133,3528,3605,7122,11,164,286.39,24.9
"2011","Basildon 002","E02004425","Total",7347,3554,3793,7288,59,105,400.13,18.4
"2011","Basildon 003","E02004426","Total",7815,3840,3975,7815,0,132,326.35,23.9
"2011","Basildon 004","E02004427","Total",7562,3641,3921,7558,4,102,532.95,14.2
"2011","Basildon 005","E02004428","Total",6176,2957,3219,6049,127,34,195.27,31.6
"2011","Basildon 006","E02004429","Total",7513,3659,3854,7463,50,56,830.52,9.0
"2011","Basildon 007","E02004430","Total",8062,3977,4085,8049,13,99,332.50,24.2
"2011","Basildon 008","E02004431","Total",9071,4448,4623,9068,3,74,461.58,19.7
"2011","Basildon 009","E02004432","Total",6892,3353,3539,6887,5,101,2102.85,3.3
"2011","Basildon 010","E02004433","Total",8611,4165,4446,8485,126,74,431.34,20.0
"2011","Basildon 011","E02004434","Total",8385,4128,4257,8265,120,66,1254.48,6.7
"2011","Basildon 012","E02004435","Total",8036,3811,4225,8035,1,41,326.51,24.6
"2011","Basildon 013","E02004436","Total",7700,3732,3968,7640,60,35,139.19,55.3
"2011","Basildon 014","E02004437","Total",7863,3805,4058,7849,14,49,483.30,16.3
"2011","Basildon 015","E02004438","Total",8621,3980,4641,8273,348,43,332.32,25.9
"2011","Basildon 016","E02004439","Total",8779,4133,4646,8779,0,50,135.82,64.6
"2011","Basildon 017","E02004440","Total",7880,3777,4103,7880,0,36,205.70,38.3
"2011","Basildon 018","E02004441","Total",7455,3628,3827,7440,15,46,200.19,37.2
"2011","Basildon 019","E02004442","Total",8187,3977,4210,8185,2,56,127.08,64.4
"2011","Basildon 020","E02004443","Total",8171,4016,4155,8145,26,83,383.78,21.3
"2011","Basildon 021","E02004444","Total",9064,4460,4604,8972,92,110,584.46,15.5
"2011","Basildon 022","E02004445","Total",8174,4076,4098,8125,49,49,929.75,8.8
"2011","Braintree 001","E02004446","Total",6878,3414,3464,6875,3,121,8661.40,0.8
"2011","Braintree 002","E02004447","Total",5839,2936,2903,5835,4,157,14186.83,0.4
"2011","Braintree 003","E02004448","Total",6349,3119,3230,6266,83,113,4196.61,1.5
"2011","Braintree 004","E02004449","Total",8483,4114,4369,8383,100,58,232.38,36.5
"2011","Braintree 005","E02004450","Total",6030,2998,3032,5993,37,145,9211.02,0.7
"2011","Braintree 006","E02004451","Total",8664,4202,4462,8448,216,124,3068.68,2.8
"2011","Braintree 007","E02004452","Total",9291,4534,4757,8913,378,105,2722.92,3.4
"2011","Braintree 008","E02004453","Total",7091,3396,3695,7037,54,62,289.71,24.5
"2011","Braintree 009","E02004454","Total",8921,4462,4459,8825,96,69,178.42,50.0
"2011","Braintree 010","E02004455","Total",7634,3718,3916,7623,11,105,1182.83,6.5
"2011","Braintree 011","E02004456","Total",8913,4415,4498,8878,35,59,217.46,41.0
"2011","Braintree 012","E02004457","Total",10331,5075,5256,10231,100,89,3575.32,2.9
"2011","Braintree 013","E02004458","Total",9519,4604,4915,9425,94,120,978.68,9.7
"2011","Braintree 014","E02004459","Total",10349,5093,5256,10248,101,166,4649.21,2.2
"2011","Braintree 015","E02004460","Total",8855,4349,4506,8825,30,72,1600.72,5.5
"2011","Braintree 016","E02004461","Total",5820,2864,2956,5820,0,63,416.88,14.0
"2011","Braintree 017","E02004462","Total",10135,4934,5201,9961,174,78,431.47,23.5
"2011","Braintree 018","E02004463","Total",7982,3910,4072,7877,105,130,5370.30,1.5
"2011","Brentwood 001","E02004464","Total",9765,4738,5027,9674,91,183,4783.31,2.0
"2011","Brentwood 002","E02004465","Total",5966,2828,3138,5950,16,107,2795.00,2.1
"2011","Brentwood 003","E02004466","Total",8084,3869,4215,8044,40,128,621.16,13.0
"2011","Brentwood 004","E02004467","Total",7574,3619,3955,7359,215,100,180.16,42.0
"2011","Brentwood 005","E02004468","Total",10452,5196,5256,10394,58,307,994.02,10.5
"2011","Brentwood 006","E02004469","Total",6862,3334,3528,6862,0,120,1691.44,4.1
"2011","Brentwood 007","E02004470","Total",10667,5179,5488,10548,119,116,247.03,43.2
"2011","Brentwood 008","E02004471","Total",8045,3785,4260,7810,235,142,1912.21,4.2
"2011","Brentwood 009","E02004472","Total",6186,3034,3152,6148,38,127,2087.42,3.0
"2011","Castle Point 001","E02004473","Total",7674,3745,3929,7674,0,57,129.15,59.4
"2011","Castle Point 002","E02004474","Total",7129,3455,3674,6980,149,78,580.16,12.3
"2011","Castle Point 003","E02004475","Total",6533,3182,3351,6533,0,69,178.64,36.6
"2011","Castle Point 004","E02004476","Total",8002,3903,4099,7967,35,117,486.98,16.4
"2011","Castle Point 005","E02004477","Total",5949,2891,3058,5946,3,75,402.99,14.8
"2011","Castle Point 006","E02004478","Total",6605,3148,3457,6495,110,77,576.17,11.5
"2011","Castle Point 007","E02004479","Total",7949,3919,4030,7828,121,70,324.89,24.5
"2011","Castle Point 008","E02004480","Total",7112,3507,3605,7100,12,53,238.68,29.8
"2011","Castle Point 009","E02004481","Total",6735,3245,3490,6733,2,30,208.49,32.3
"2011","Castle Point 010","E02004482","Total",8394,4040,4354,8310,84,31,797.90,10.5
"2011","Castle Point 011","E02004483","Total",8166,4063,4103,8084,82,56,376.81,21.7
"2011","Castle Point 012","E02004484","Total",7763,3809,3954,7735,28,48,206.00,37.7
"2011","Chelmsford 001","E02004485","Total",7006,3454,3552,6987,19,116,5550.49,1.3
"2011","Chelmsford 002","E02004486","Total",8197,3957,4240,8012,185,141,689.63,11.9
"2011","Chelmsford 003","E02004487","Total",7077,3472,3605,7048,29,105,3837.57,1.8
"2011","Chelmsford 004","E02004488","Total",8254,4079,4175,8187,67,122,311.06,26.5
"2011","Chelmsford 005","E02004489","Total",9209,4511,4698,9038,171,166,2872.75,3.2
"2011","Chelmsford 006","E02004490","Total",7716,3672,4044,7672,44,65,149.95,51.5
"2011","Chelmsford 007","E02004491","Total",7370,3655,3715,7369,1,137,196.08,37.6
"2011","Chelmsford 008","E02004492","Total",9290,4561,4729,9290,0,141,322.32,28.8
"2011","Chelmsford 009","E02004493","Total",10127,5022,5105,9983,144,147,304.70,33.2
"2011","Chelmsford 010","E02004494","Total",9565,5064,4501,8904,661,77,285.79,33.5
"2011","Chelmsford 011","E02004495","Total",8186,3956,4230,7879,307,122,4068.13,2.0
"2011","Chelmsford 012","E02004496","Total",7403,3648,3755,7245,158,122,187.61,39.5
"2011","Chelmsford 013","E02004497","Total",7848,3841,4007,7779,69,147,1472.78,5.3
"2011","Chelmsford 014","E02004498","Total",9720,4738,4982,9720,0,103,295.91,32.8
"2011","Chelmsford 015","E02004499","Total",6927,3379,3548,6927,0,103,104.91,66.0
"2011","Chelmsford 016","E02004500","Total",9147,4505,4642,9094,53,175,3411.13,2.7
"2011","Chelmsford 017","E02004501","Total",7243,3538,3705,7243,0,118,1182.52,6.1
"2011","Chelmsford 018","E02004502","Total",6551,3265,3286,6542,9,120,5462.70,1.2
"2011","Chelmsford 019","E02004503","Total",8087,4018,4069,8087,0,100,521.01,15.5
"2011","Chelmsford 020","E02004504","Total",8366,4105,4261,8294,72,157,331.49,25.2
"2011","Chelmsford 021","E02004505","Total",5021,2474,2547,4882,139,41,2319.03,2.2
"2011","Colchester 001","E02004506","Total",6798,3346,3452,6686,112,162,4726.37,1.4
"2011","Colchester 002","E02004507","Total",9987,4928,5059,9916,71,141,339.05,29.5
"2011","Colchester 003","E02004508","Total",6551,3228,3323,6480,71,119,3892.13,1.7
"2011","Colchester 004","E02004509","Total",10565,5238,5327,10398,167,110,765.36,13.8
"2011","Colchester 007","E02004512","Total",9996,4975,5021,9809,187,100,350.82,28.5
"2011","Colchester 008","E02004513","Total",10991,5345,5646,10216,775,77,188.69,58.2
"2011","Colchester 009","E02004514","Total",5549,2626,2923,5444,105,103,457.19,12.1
"2011","Colchester 010","E02004515","Total",7161,3577,3584,7058,103,135,5382.94,1.3
"2011","Colchester 011","E02004516","Total",10682,5807,4875,9331,1351,71,177.53,60.2
"2011","Colchester 012","E02004517","Total",8283,3979,4304,8157,126,99,911.40,9.1
"2011","Colchester 013","E02004518","Total",6208,3125,3083,6171,37,138,226.64,27.4
"2011","Colchester 014","E02004519","Total",7396,3556,3840,7347,49,159,196.85,37.6
"2011","Colchester 015","E02004520","Total",8360,4110,4250,8355,5,70,465.64,18.0
"2011","Colchester 016","E02004521","Total",8814,4239,4575,8712,102,55,961.08,9.2
"2011","Colchester 017","E02004522","Total",10025,4887,5138,7892,2133,145,727.11,13.8
"2011","Colchester 018","E02004523","Total",9014,4544,4470,8757,257,62,494.87,18.2
"2011","Colchester 019","E02004524","Total",8247,4082,4165,8127,120,147,10282.69,0.8
"2011","Colchester 020","E02004525","Total",7583,3671,3912,7558,25,62,833.47,9.1
"2011","Colchester 021","E02004526","Total",7183,3404,3779,7172,11,92,1061.37,6.8
"2011","Colchester 022","E02006922","Total",13681,6676,7005,13494,187,162,466.97,29.3
"2011","Epping Forest 001","E02004527","Total",8629,4251,4378,8586,43,118,3882.72,2.2
"2011","Epping Forest 002","E02004528","Total",8037,3968,4069,8031,6,104,4512.24,1.8
"2011","Epping Forest 003","E02004529","Total",6615,3304,3311,6598,17,120,13754.33,0.5
"2011","Epping Forest 004","E02004530","Total",6251,3009,3242,6251,0,85,901.80,6.9
"2011","Epping Forest 005","E02004531","Total",6238,2971,3267,6169,69,88,795.79,7.8
"2011","Epping Forest 006","E02004532","Total",6192,2968,3224,6128,64,67,472.63,13.1
"2011","Epping Forest 007","E02004533","Total",7156,3417,3739,7009,147,59,218.82,32.7
"2011","Epping Forest 008","E02004534","Total",8758,4313,4445,8678,80,64,331.99,26.4
"2011","Epping Forest 009","E02004535","Total",5235,2616,2619,5149,86,42,3689.79,1.4
"2011","Epping Forest 010","E02004536","Total",6075,2939,3136,5991,84,99,1873.35,3.2
"2011","Epping Forest 011","E02004537","Total",8550,4135,4415,8550,0,60,316.25,27.0
"2011","Epping Forest 012","E02004538","Total",8971,4356,4615,8889,82,188,707.78,12.7
"2011","Epping Forest 013","E02004539","Total",7612,3621,3991,7612,0,68,179.09,42.5
"2011","Epping Forest 014","E02004540","Total",5973,2890,3083,5948,25,112,309.01,19.3
"2011","Epping Forest 015","E02004541","Total",11380,5422,5958,11201,179,186,385.21,29.5
"2011","Epping Forest 016","E02004542","Total",6367,3117,3250,6323,44,140,1397.00,4.6
"2011","Epping Forest 017","E02004543","Total",6620,3143,3477,6510,110,106,170.76,38.8
"2011","Harlow 001","E02004544","Total",6968,3360,3608,6949,19,81,602.61,11.6
"2011","Harlow 002","E02004545","Total",7184,3418,3766,7133,51,59,363.27,19.8
"2011","Harlow 003","E02004546","Total",7423,3628,3795,7396,27,47,245.09,30.3
"2011","Harlow 004","E02004547","Total",7957,3819,4138,7885,72,49,559.47,14.2
"2011","Harlow 005","E02004548","Total",8895,4327,4568,8883,12,56,161.20,55.2
"2011","Harlow 006","E02004549","Total",7694,3691,4003,7622,72,75,173.56,44.3
"2011","Harlow 007","E02004550","Total",7662,3698,3964,7577,85,56,181.13,42.3
"2011","Harlow 008","E02004551","Total",7206,3432,3774,7188,18,50,200.30,36.0
"2011","Harlow 009","E02004552","Total",6455,3172,3283,6439,16,68,169.94,38.0
"2011","Harlow 010","E02004553","Total",7270,3530,3740,7264,6,64,154.12,47.2
"2011","Harlow 011","E02004554","Total",7230,3599,3631,7215,15,82,243.06,29.7
"2011","Maldon 001","E02004555","Total",6042,2997,3045,5944,98,101,5936.47,1.0
"2011","Maldon 002","E02004556","Total",7160,3538,3622,7125,35,149,6890.86,1.0
"2011","Maldon 003","E02004557","Total",8175,4045,4130,8067,108,70,682.90,12.0
"2011","Maldon 004","E02004558","Total",6428,3060,3368,6328,100,46,771.59,8.3
"2011","Maldon 005","E02004559","Total",7792,3788,4004,7759,33,103,457.22,17.0
"2011","Maldon 006","E02004560","Total",8332,4173,4159,8225,107,71,10445.40,0.8
"2011","Maldon 007","E02004561","Total",10029,5051,4978,9990,39,135,8527.76,1.2
"2011","Maldon 008","E02004562","Total",7671,3806,3865,7659,12,99,2164.56,3.5
"2011","Rochford 001","E02004563","Total",6527,3217,3310,6523,4,65,783.78,8.3
"2011","Rochford 002","E02004564","Total",7969,3906,4063,7945,24,95,1203.70,6.6
"2011","Rochford 003","E02004565","Total",14876,7299,7577,14876,0,183,1085.08,13.7
"2011","Rochford 004","E02004566","Total",5725,2748,2977,5649,76,43,4535.51,1.3
"2011","Rochford 005","E02004567","Total",8151,4069,4082,7909,242,89,386.09,21.1
"2011","Rochford 006","E02004568","Total",8543,4187,4356,8506,37,60,1298.48,6.6
"2011","Rochford 007","E02004569","Total",7300,3562,3738,7251,49,67,1061.55,6.9
"2011","Rochford 008","E02004570","Total",8683,4133,4550,8621,62,104,334.91,25.9
"2011","Rochford 009","E02004571","Total",7899,3905,3994,7890,9,88,291.36,27.1
"2011","Rochford 010","E02004572","Total",7614,3761,3853,7566,48,94,5969.38,1.3
"2011","Tendring 001","E02004573","Total",6072,3012,3060,5980,92,38,168.83,36.0
"2011","Tendring 002","E02004574","Total",7312,3533,3779,7312,0,42,392.21,18.6
"2011","Tendring 003","E02004575","Total",11138,5382,5756,10985,153,147,6566.53,1.7
"2011","Tendring 004","E02004576","Total",8831,4289,4542,8754,77,92,3510.60,2.5
"2011","Tendring 005","E02004577","Total",5203,2623,2580,5103,100,105,5459.08,1.0
"2011","Tendring 006","E02004578","Total",7149,3256,3893,6912,237,87,673.92,10.6
"2011","Tendring 007","E02004579","Total",6890,3398,3492,6810,80,60,4910.88,1.4
"2011","Tendring 008","E02004580","Total",11696,5390,6306,11574,122,142,1819.55,6.4
"2011","Tendring 009","E02004581","Total",7410,3667,3743,7259,151,99,3891.48,1.9
"2011","Tendring 010","E02004582","Total",6689,3114,3575,6683,6,34,609.79,11.0
"2011","Tendring 011","E02004583","Total",8299,4055,4244,8204,95,66,977.13,8.5
"2011","Tendring 012","E02004584","Total",6441,3015,3426,6385,56,42,275.94,23.3
"2011","Tendring 013","E02004585","Total",7652,3676,3976,7630,22,61,547.15,14.0
"2011","Tendring 014","E02004586","Total",8145,3841,4304,7893,252,73,259.77,31.4
"2011","Tendring 015","E02004587","Total",7744,3643,4101,7744,0,40,226.83,34.1
"2011","Tendring 016","E02004588","Total",6475,3122,3353,5991,484,48,103.52,62.5
"2011","Tendring 017","E02004589","Total",7402,3430,3972,7199,203,47,243.09,30.4
"2011","Tendring 018","E02004590","Total",7500,3625,3875,7449,51,33,3127.82,2.4
"2011","Uttlesford 001","E02004591","Total",6847,3354,3493,6797,50,221,6661.13,1.0
"2011","Uttlesford 002","E02004592","Total",12102,5878,6224,11930,172,200,763.78,15.8
"2011","Uttlesford 003","E02004593","Total",8132,4020,4112,8128,4,255,11043.72,0.7
"2011","Uttlesford 004","E02004594","Total",7819,3982,3837,7528,291,190,12553.33,0.6
"2011","Uttlesford 005","E02004595","Total",11911,5903,6008,11811,100,248,6987.30,1.7
"2011","Uttlesford 006","E02004596","Total",7662,3844,3818,7617,45,107,6732.00,1.1
"2011","Uttlesford 007","E02004597","Total",7267,3504,3763,7219,48,118,2165.70,3.4
"2011","Uttlesford 008","E02004598","Total",10349,5110,5239,9963,386,237,8633.58,1.2
"2011","Uttlesford 009","E02004599","Total",7354,3608,3746,7302,52,145,8577.74,0.9
"2011","Broxbourne 001","E02004843","Total",7181,3502,3679,7107,74,94,171.23,41.9
"2011","Broxbourne 002","E02004844","Total",7187,3498,3689,7186,1,49,228.72,31.4
"2011","Broxbourne 003","E02004845","Total",7240,3584,3656,7217,23,61,728.04,9.9
"2011","Broxbourne 004","E02004846","Total",6238,3072,3166,6203,35,108,411.70,15.2
"2011","Broxbourne 005","E02004847","Total",9763,4678,5085,9674,89,100,403.08,24.2
"2011","Broxbourne 006","E02004848","Total",7192,3454,3738,7192,0,77,805.10,8.9
"2011","Broxbourne 007","E02004849","Total",6836,3369,3467,6836,0,90,1015.71,6.7
"2011","Broxbourne 008","E02004850","Total",7446,3587,3859,7446,0,62,197.11,37.8
"2011","Broxbourne 009","E02004851","Total",5800,2755,3045,5749,51,52,129.89,44.7
"2011","Broxbourne 010","E02004852","Total",7646,3697,3949,7612,34,79,161.93,47.2
"2011","Broxbourne 011","E02004853","Total",6336,3032,3304,6305,31,64,478.86,13.2
"2011","Broxbourne 012","E02004854","Total",7337,3562,3775,7333,4,74,200.16,36.7
"2011","Broxbourne 013","E02004855","Total",7407,3567,3840,7407,0,44,212.03,34.9
"2011","Dacorum 001","E02004856","Total",5413,2699,2714,5323,90,96,4992.63,1.1
"2011","Dacorum 002","E02004857","Total",5663,2693,2970,5433,230,152,2067.47,2.7
"2011","Dacorum 003","E02004858","Total",5078,2482,2596,5072,6,98,252.77,20.1
"2011","Dacorum 004","E02004859","Total",5195,2563,2632,5187,8,159,2742.41,1.9
"2011","Dacorum 005","E02004860","Total",5765,2880,2885,5765,0,85,88.22,65.3
"2011","Dacorum 006","E02004861","Total",5484,2665,2819,5457,27,133,3343.56,1.6
"2011","Dacorum 007","E02004862","Total",7574,3821,3753,7558,16,72,176.29,43.0
"2011","Dacorum 008","E02004863","Total",7764,3752,4012,7625,139,61,142.45,54.5
"2011","Dacorum 009","E02004864","Total",6282,3061,3221,6243,39,161,511.50,12.3
"2011","Dacorum 010","E02004865","Total",5332,2607,2725,5323,9,89,241.55,22.1
"2011","Dacorum 011","E02004866","Total",6577,3176,3401,6513,64,84,273.58,24.0
"2011","Dacorum 012","E02004867","Total",6083,2947,3136,6042,41,171,245.87,24.7
"2011","Dacorum 013","E02004868","Total",5848,2796,3052,5679,169,62,397.67,14.7
"2011","Dacorum 014","E02004869","Total",5650,2742,2908,5579,71,125,520.84,10.8
"2011","Dacorum 015","E02004870","Total",9390,4599,4791,9238,152,72,227.23,41.3
"2011","Dacorum 016","E02004871","Total",5068,2500,2568,5068,0,100,260.15,19.5
"2011","Dacorum 017","E02004872","Total",6961,3428,3533,6955,6,104,182.89,38.1
"2011","Dacorum 018","E02004873","Total",10069,5070,4999,10024,45,173,329.47,30.6
"2011","Dacorum 019","E02004874","Total",6183,3015,3168,6127,56,76,122.44,50.5
"2011","Dacorum 020","E02004875","Total",9255,4541,4714,9237,18,98,328.58,28.2
"2011","Dacorum 021","E02004876","Total",8999,4769,4230,8216,783,193,2967.68,3.0
"2011","Dacorum 022","E02004877","Total",5214,2501,2713,5181,33,90,832.31,6.3
"2011","East Hertfordshire 001","E02004878","Total",6715,3352,3363,6662,53,138,5170.69,1.3
"2011","East Hertfordshire 002","E02004879","Total",7720,3847,3873,7678,42,174,9830.81,0.8
"2011","East Hertfordshire 003","E02004880","Total",9178,4497,4681,9052,126,272,6161.36,1.5
"2011","East Hertfordshire 004","E02004881","Total",5698,2794,2904,5660,38,122,356.16,16.0
"2011","East Hertfordshire 005","E02004882","Total",8000,3896,4104,7730,270,171,282.03,28.4
"2011","East Hertfordshire 006","E02004883","Total",5741,2871,2870,5628,113,99,3955.24,1.5
"2011","East Hertfordshire 007","E02004884","Total",9829,4785,5044,9794,35,119,188.79,52.1
"2011","East Hertfordshire 008","E02004885","Total",8804,4354,4450,8757,47,194,350.08,25.1
"2011","East Hertfordshire 009","E02004886","Total",5633,2738,2895,5428,205,145,6979.25,0.8
"2011","East Hertfordshire 010","E02004887","Total",7129,3486,3643,7119,10,191,7317.21,1.0
"2011","East Hertfordshire 011","E02004888","Total",8458,4173,4285,8324,134,135,997.50,8.5
"2011","East Hertfordshire 012","E02004889","Total",10528,5119,5409,10333,195,142,247.29,42.6
"2011","East Hertfordshire 013","E02004890","Total",8271,4107,4164,8220,51,138,391.52,21.1
"2011","East Hertfordshire 014","E02004891","Total",7456,3589,3867,7403,53,149,680.38,11.0
"2011","East Hertfordshire 015","E02004892","Total",5564,2690,2874,5547,17,67,274.85,20.2
"2011","East Hertfordshire 016","E02004893","Total",5453,2683,2770,5453,0,110,197.06,27.7
"2011","East Hertfordshire 017","E02004894","Total",8310,4166,4144,8297,13,176,667.24,12.5
"2011","East Hertfordshire 018","E02004895","Total",9200,4543,4657,8677,523,191,3521.22,2.6
"2011","Hertsmere 001","E02004896","Total",7875,3681,4194,7725,150,145,712.52,11.1
"2011","Hertsmere 002","E02004897","Total",6663,3185,3478,6654,9,103,487.97,13.7
"2011","Hertsmere 003","E02004898","Total",7344,3450,3894,7215,129,97,309.54,23.7
"2011","Hertsmere 004","E02004899","Total",5506,2633,2873,5345,161,94,3462.49,1.6
"2011","Hertsmere 005","E02004900","Total",8163,4038,4125,8148,15,291,931.65,8.8
"2011","Hertsmere 006","E02004901","Total",8439,4020,4419,8354,85,96,212.38,39.7
"2011","Hertsmere 007","E02004902","Total",7928,3831,4097,7916,12,100,168.44,47.1
"2011","Hertsmere 008","E02004903","Total",6727,3283,3444,6482,245,125,512.55,13.1
"2011","Hertsmere 009","E02004904","Total",5906,2918,2988,5868,38,62,209.36,28.2
"2011","Hertsmere 010","E02004905","Total",6762,3326,3436,6453,309,170,1821.76,3.7
"2011","Hertsmere 011","E02004906","Total",9682,4802,4880,9541,141,103,227.89,42.5
"2011","Hertsmere 012","E02004907","Total",9263,4410,4853,9140,123,184,414.66,22.3
"2011","Hertsmere 013","E02004908","Total",9773,4713,5060,9637,136,275,644.79,15.2
"2011","North Hertfordshire 001","E02004909","Total",5119,2518,2601,5070,49,41,122.39,41.8
"2011","North Hertfordshire 002","E02004910","Total",10662,5311,5351,10642,20,177,721.93,14.8
"2011","North Hertfordshire 003","E02004911","Total",6538,3173,3365,6538,0,63,469.06,13.9
"2011","North Hertfordshire 004","E02004912","Total",10280,5126,5154,10090,190,142,321.81,31.9
"2011","North Hertfordshire 005","E02004913","Total",14741,7306,7435,14600,141,278,17778.82,0.8
"2011","North Hertfordshire 006","E02004914","Total",7373,3542,3831,7261,112,80,346.96,21.3
"2011","North Hertfordshire 007","E02004915","Total",5411,2611,2800,5411,0,60,182.50,29.6
"2011","North Hertfordshire 008","E02004916","Total",7337,3525,3812,7183,154,173,457.18,16.0
"2011","North Hertfordshire 009","E02004917","Total",6590,3220,3370,6504,86,106,555.49,11.9
"2011","North Hertfordshire 010","E02004918","Total",8097,4103,3994,8073,24,112,377.47,21.5
"2011","North Hertfordshire 011","E02004919","Total",7288,3633,3655,7288,0,112,344.25,21.2
"2011","North Hertfordshire 012","E02004920","Total",10654,5159,5495,10466,188,196,659.50,16.2
"2011","North Hertfordshire 013","E02004921","Total",7562,3657,3905,7499,63,147,182.83,41.4
"2011","North Hertfordshire 014","E02004922","Total",9455,4623,4832,9296,159,194,11043.54,0.9
"2011","North Hertfordshire 015","E02004923","Total",10007,4873,5134,9896,111,248,3973.78,2.5
"2011","St Albans 001","E02004924","Total",7239,3499,3740,7049,190,216,330.08,21.9
"2011","St Albans 002","E02004925","Total",7691,3802,3889,7489,202,166,265.92,28.9
"2011","St Albans 003","E02004926","Total",7743,3715,4028,7615,128,262,310.28,25.0
"2011","St Albans 004","E02004927","Total",6410,3059,3351,6397,13,181,2598.74,2.5
"2011","St Albans 005","E02004928","Total",6775,3368,3407,6775,0,252,371.75,18.2
"2011","St Albans 006","E02004929","Total",6226,3027,3199,6156,70,134,4950.91,1.3
"2011","St Albans 007","E02004930","Total",6826,3310,3516,6758,68,133,1444.62,4.7
"2011","St Albans 008","E02004931","Total",6497,3170,3327,6497,0,155,195.24,33.3
"2011","St Albans 009","E02004932","Total",7703,3602,4101,7523,180,117,214.86,35.9
"2011","St Albans 010","E02004933","Total",6907,3384,3523,6887,20,244,187.57,36.8
"2011","St Albans 011","E02004934","Total",7158,3566,3592,7126,32,117,149.52,47.9
"2011","St Albans 012","E02004935","Total",7602,3885,3717,7489,113,101,128.40,59.2
"2011","St Albans 013","E02004936","Total",6178,3113,3065,6159,19,110,105.63,58.5
"2011","St Albans 014","E02004937","Total",6404,3177,3227,6339,65,146,362.06,17.7
"2011","St Albans 015","E02004938","Total",5962,3014,2948,5873,89,96,1118.85,5.3
"2011","St Albans 016","E02004939","Total",6614,3274,3340,6569,45,111,236.16,28.0
"2011","St Albans 017","E02004940","Total",7357,3597,3760,7252,105,78,305.22,24.1
"2011","St Albans 018","E02004941","Total",9507,4661,4846,9440,67,107,512.98,18.5
"2011","St Albans 019","E02004942","Total",6130,3058,3072,6034,96,76,937.54,6.5
"2011","St Albans 020","E02004943","Total",7735,3759,3976,7631,104,163,1391.30,5.6
"2011","Stevenage 001","E02004944","Total",6746,3379,3367,6725,21,78,117.31,57.5
"2011","Stevenage 002","E02004945","Total",11794,5775,6019,11614,180,167,495.42,23.8
"2011","Stevenage 003","E02004946","Total",6329,3182,3147,6238,91,59,102.75,61.6
"2011","Stevenage 004","E02004947","Total",6326,3187,3139,6290,36,84,127.75,49.5
"2011","Stevenage 005","E02004948","Total",5795,2870,2925,5780,15,69,318.97,18.2
"2011","Stevenage 006","E02004949","Total",8000,4023,3977,7968,32,64,179.93,44.5
"2011","Stevenage 007","E02004950","Total",6779,3320,3459,6774,5,62,139.82,48.5
"2011","Stevenage 008","E02004951","Total",7015,3450,3565,7009,6,29,259.14,27.1
"2011","Stevenage 009","E02004952","Total",6658,3259,3399,6564,94,69,135.32,49.2
"2011","Stevenage 010","E02004953","Total",6210,3017,3193,6210,0,64,169.60,36.6
"2011","Stevenage 011","E02004954","Total",6395,3135,3260,6344,51,58,327.12,19.5
"2011","Stevenage 012","E02004955","Total",5910,2886,3024,5889,21,68,223.27,26.5
"2011","Three Rivers 001","E02004956","Total",8815,4411,4404,8761,54,134,994.06,8.9
"2011","Three Rivers 002","E02004957","Total",8732,4255,4477,8680,52,94,449.25,19.4
"2011","Three Rivers 003","E02004958","Total",7197,3411,3786,7149,48,180,2573.23,2.8
"2011","Three Rivers 004","E02004959","Total",5808,2702,3106,5533,275,213,650.20,8.9
"2011","Three Rivers 005","E02004960","Total",5567,2718,2849,5560,7,183,466.17,11.9
"2011","Three Rivers 006","E02004961","Total",9241,4531,4710,9241,0,211,393.56,23.5
"2011","Three Rivers 007","E02004962","Total",8521,4180,4341,8369,152,152,238.83,35.7
"2011","Three Rivers 008","E02004963","Total",7029,3429,3600,6991,38,110,340.14,20.7
"2011","Three Rivers 009","E02004964","Total",5602,2677,2925,5582,20,68,1092.33,5.1
"2011","Three Rivers 010","E02004965","Total",6532,3117,3415,6504,28,97,273.60,23.9
"2011","Three Rivers 011","E02004966","Total",6967,3459,3508,6712,255,292,1208.08,5.8
"2011","Three Rivers 012","E02004967","Total",7306,3481,3825,7242,64,59,201.89,36.2
"2011","Watford 001","E02004968","Total",7083,3441,3642,7041,42,80,167.43,42.3
"2011","Watford 002","E02004969","Total",7195,3473,3722,7156,39,93,138.89,51.8
"2011","Watford 003","E02004970","Total",7832,3723,4109,7817,15,73,199.43,39.3
"2011","Watford 004","E02004971","Total",7484,3714,3770,7417,67,79,135.49,55.2
"2011","Watford 005","E02004972","Total",6100,3075,3025,6100,0,91,175.67,34.7
"2011","Watford 006","E02004973","Total",7444,3776,3668,7444,0,50,83.73,88.9
"2011","Watford 007","E02004974","Total",7606,3735,3871,7358,248,149,179.01,42.5
"2011","Watford 008","E02004975","Total",7778,3895,3883,7761,17,213,430.87,18.1
"2011","Watford 009","E02004976","Total",8143,4259,3884,8053,90,50,192.19,42.4
"2011","Watford 010","E02004977","Total",8258,4229,4029,8202,56,103,94.89,87.0
"2011","Watford 011","E02004978","Total",8626,4194,4432,8494,132,78,192.37,44.8
"2011","Watford 012","E02004979","Total",6752,3314,3438,6722,30,149,152.51,44.3
"2011","Welwyn Hatfield 001","E02004980","Total",5995,2942,3053,5932,63,149,890.95,6.7
"2011","Welwyn Hatfield 002","E02004981","Total",7189,3553,3636,7141,48,138,2548.75,2.8
"2011","Welwyn Hatfield 003","E02004982","Total",5923,2797,3126,5917,6,85,308.72,19.2
"2011","Welwyn Hatfield 004","E02004983","Total",5964,2888,3076,5964,0,62,267.87,22.3
"2011","Welwyn Hatfield 005","E02004984","Total",6314,3176,3138,6261,53,95,201.89,31.3
"2011","Welwyn Hatfield 006","E02004985","Total",6806,3182,3624,6745,61,138,359.26,18.9
"2011","Welwyn Hatfield 007","E02004986","Total",7431,3538,3893,7331,100,39,183.82,40.4
"2011","Welwyn Hatfield 008","E02004987","Total",6740,3281,3459,6734,6,92,217.06,31.1
"2011","Welwyn Hatfield 009","E02004988","Total",7441,3619,3822,7384,57,67,192.52,38.7
"2011","Welwyn Hatfield 010","E02004989","Total",12612,6325,6287,9883,2729,129,502.74,25.1
"2011","Welwyn Hatfield 011","E02004990","Total",6371,3240,3131,6276,95,72,2173.07,2.9
"2011","Welwyn Hatfield 012","E02004991","Total",7324,3719,3605,7244,80,66,141.08,51.9
"2011","Welwyn Hatfield 013","E02004992","Total",8119,4279,3840,8017,102,98,173.85,46.7
"2011","Welwyn Hatfield 014","E02004993","Total",5251,2543,2708,5157,94,65,1130.94,4.6
"2011","Welwyn Hatfield 015","E02004994","Total",5874,2715,3159,5664,210,175,2120.26,2.8
"2011","Welwyn Hatfield 016","E02004995","Total",5181,2567,2614,5180,1,139,1542.64,3.4
"2011","Breckland 001","E02005503","Total",7111,3631,3480,6724,387,119,10751.97,0.7
"2011","Breckland 002","E02005504","Total",8735,4305,4430,8643,92,128,19916.67,0.4
"2011","Breckland 003","E02005505","Total",7184,3432,3752,6971,213,80,1544.55,4.7
"2011","Breckland 004","E02005506","Total",6849,3399,3450,6758,91,91,6294.26,1.1
"2011","Breckland 005","E02005507","Total",11425,5541,5884,11349,76,98,606.65,18.8
"2011","Breckland 006","E02005508","Total",6640,3249,3391,6587,53,110,9701.11,0.7
"2011","Breckland 007","E02005509","Total",7258,3359,3899,7001,257,53,2957.13,2.5
"2011","Breckland 008","E02005510","Total",6641,3192,3449,6587,54,76,8484.76,0.8
"2011","Breckland 009","E02005511","Total",7202,3507,3695,7069,133,50,719.99,10.0
"2011","Breckland 010","E02005512","Total",8810,4828,3982,7894,916,89,15401.30,0.6
"2011","Breckland 011","E02005513","Total",9009,4403,4606,8860,149,79,2137.64,4.2
"2011","Breckland 012","E02005514","Total",6554,3272,3282,6462,92,74,27334.71,0.2
"2011","Breckland 013","E02005515","Total",6223,3103,3120,6104,119,139,7879.69,0.8
"2011","Breckland 014","E02005516","Total",6510,3246,3264,6459,51,78,13826.41,0.5
"2011","Breckland 015","E02005517","Total",5910,2910,3000,5899,11,45,856.68,6.9
"2011","Breckland 016","E02005518","Total",10635,5346,5289,10494,141,67,272.71,39.0
"2011","Breckland 017","E02005519","Total",7795,3843,3952,7771,24,54,1825.41,4.3
"2011","Broadland 001","E02005520","Total",7378,3552,3826,7254,124,110,5081.75,1.5
"2011","Broadland 002","E02005521","Total",8519,4217,4302,8503,16,144,15736.90,0.5
"2011","Broadland 003","E02005522","Total",5302,2594,2708,5184,118,66,4148.28,1.3
"2011","Broadland 004","E02005523","Total",7737,3824,3913,7612,125,83,5101.07,1.5
"2011","Broadland 005","E02005524","Total",5442,2697,2745,5374,68,37,1468.65,3.7
"2011","Broadland 006","E02005525","Total",10142,4984,5158,9898,244,132,869.83,11.7
"2011","Broadland 007","E02005526","Total",5489,2632,2857,5354,135,53,556.36,9.9
"2011","Broadland 008","E02005527","Total",8229,4022,4207,8034,195,95,3723.07,2.2
"2011","Broadland 009","E02005528","Total",8458,4123,4335,8418,40,89,322.21,26.2
"2011","Broadland 010","E02005529","Total",5807,2772,3035,5729,78,42,323.26,18.0
"2011","Broadland 011","E02005530","Total",5150,2565,2585,5084,66,33,200.44,25.7
"2011","Broadland 012","E02005531","Total",5483,2626,2857,5444,39,51,315.58,17.4
"2011","Broadland 013","E02005532","Total",6858,3359,3499,6829,29,55,541.04,12.7
"2011","Broadland 014","E02005533","Total",8237,3944,4293,8169,68,119,6084.81,1.4
"2011","Broadland 015","E02005534","Total",7296,3518,3778,7296,0,66,287.25,25.4
"2011","Broadland 016","E02005535","Total",7260,3580,3680,7087,173,103,421.01,17.2
"2011","Broadland 017","E02005536","Total",5790,2814,2976,5671,119,93,3728.14,1.6
"2011","Broadland 018","E02005537","Total",6069,2971,3098,5991,78,68,6330.23,1.0
"2011","Great Yarmouth 001","E02005538","Total",9118,4415,4703,8955,163,134,3212.26,2.8
"2011","Great Yarmouth 002","E02005539","Total",7544,3696,3848,7478,66,89,7373.67,1.0
"2011","Great Yarmouth 003","E02005540","Total",9076,4375,4701,9022,54,67,1072.66,8.5
"2011","Great Yarmouth 004","E02005541","Total",6078,2954,3124,6028,50,34,227.29,26.7
"2011","Great Yarmouth 005","E02005542","Total",6866,3348,3518,6683,183,13,717.35,9.6
"2011","Great Yarmouth 006","E02005543","Total",8681,4475,4206,8518,163,42,255.10,34.0
"2011","Great Yarmouth 007","E02005544","Total",7134,3587,3547,7105,29,45,333.66,21.4
"2011","Great Yarmouth 008","E02005545","Total",6448,3190,3258,6394,54,35,479.47,13.4
"2011","Great Yarmouth 009","E02005546","Total",7888,3827,4061,7858,30,46,150.25,52.5
"2011","Great Yarmouth 010","E02005547","Total",9003,4388,4615,8859,144,88,247.02,36.4
"2011","Great Yarmouth 011","E02005548","Total",7256,3515,3741,7193,63,40,168.53,43.1
"2011","Great Yarmouth 012","E02005549","Total",5479,2730,2749,5449,30,61,2185.58,2.5
"2011","Great Yarmouth 013","E02005550","Total",6706,3262,3444,6688,18,57,995.99,6.7
"2011","King's Lynn and West Norfolk 001","E02005551","Total",5420,2521,2899,5231,189,82,2799.66,1.9
"2011","King's Lynn and West Norfolk 002","E02005552","Total",7072,3459,3613,7015,57,155,24619.72,0.3
"2011","King's Lynn and West Norfolk 003","E02005553","Total",8782,4142,4640,8625,157,107,7237.23,1.2
"2011","King's Lynn and West Norfolk 004","E02005554","Total",6896,3240,3656,6874,22,74,11232.42,0.6
"2011","King's Lynn and West Norfolk 005","E02005555","Total",6908,3337,3571,6814,94,162,3720.85,1.9
"2011","King's Lynn and West Norfolk 006","E02005556","Total",7681,3741,3940,7581,100,80,255.69,30.0
"2011","King's Lynn and West Norfolk 007","E02005557","Total",6072,2958,3114,6031,41,31,458.83,13.2
"2011","King's Lynn and West Norfolk 008","E02005558","Total",6869,3363,3506,6832,37,66,7120.17,1.0
"2011","King's Lynn and West Norfolk 009","E02005559","Total",7022,3433,3589,6872,150,59,245.91,28.6
"2011","King's Lynn and West Norfolk 010","E02005560","Total",8506,4129,4377,8418,88,72,303.94,28.0
"2011","King's Lynn and West Norfolk 011","E02005561","Total",9832,4906,4926,9771,61,51,1466.40,6.7
"2011","King's Lynn and West Norfolk 012","E02005562","Total",7008,3396,3612,6978,30,112,13254.66,0.5
"2011","King's Lynn and West Norfolk 013","E02005563","Total",7448,3717,3731,7377,71,77,8761.00,0.9
"2011","King's Lynn and West Norfolk 014","E02005564","Total",10270,5355,4915,9392,878,165,9566.00,1.1
"2011","King's Lynn and West Norfolk 015","E02005565","Total",7024,3442,3582,6982,42,73,7155.20,1.0
"2011","King's Lynn and West Norfolk 016","E02005566","Total",9527,4697,4830,9503,24,96,11588.63,0.8
"2011","King's Lynn and West Norfolk 017","E02005567","Total",9994,4752,5242,9871,123,95,520.36,19.2
"2011","King's Lynn and West Norfolk 018","E02005568","Total",7189,3535,3654,7188,1,115,15556.22,0.5
"2011","King's Lynn and West Norfolk 019","E02005569","Total",7931,3930,4001,7898,33,68,17016.51,0.5
"2011","North Norfolk 001","E02005570","Total",7367,3453,3914,7158,209,100,371.50,19.8
"2011","North Norfolk 002","E02005571","Total",5952,2856,3096,5867,85,106,14422.21,0.4
"2011","North Norfolk 003","E02005572","Total",7683,3634,4049,7423,260,61,434.71,17.7
"2011","North Norfolk 004","E02005573","Total",5704,2667,3037,5341,363,91,4265.30,1.3
"2011","North Norfolk 005","E02005574","Total",6757,3322,3435,6633,124,109,5564.97,1.2
"2011","North Norfolk 006","E02005575","Total",6981,3411,3570,6872,109,119,14609.09,0.5
"2011","North Norfolk 007","E02005576","Total",6647,3184,3463,6560,87,76,4715.10,1.4
"2011","North Norfolk 008","E02005577","Total",5948,2939,3009,5888,60,89,9781.92,0.6
"2011","North Norfolk 009","E02005578","Total",5728,2808,2920,5715,13,85,14100.81,0.4
"2011","North Norfolk 010","E02005579","Total",12634,6015,6619,12380,254,99,1727.26,7.3
"2011","North Norfolk 011","E02005580","Total",7617,3647,3970,7512,105,58,903.59,8.4
"2011","North Norfolk 012","E02005581","Total",7704,4067,3637,7089,615,84,10262.59,0.8
"2011","North Norfolk 013","E02005582","Total",6502,3184,3318,6422,80,68,5967.06,1.1
"2011","North Norfolk 014","E02005583","Total",8275,4016,4259,8163,112,74,9206.96,0.9
"2011","Norwich 001","E02005584","Total",10596,5349,5247,10479,117,81,567.19,18.7
"2011","Norwich 002","E02005585","Total",10655,5293,5362,10601,54,44,275.01,38.7
"2011","Norwich 003","E02005586","Total",9934,4951,4983,9838,96,42,134.85,73.7
"2011","Norwich 004","E02005587","Total",9855,4976,4879,9420,435,43,229.96,42.9
"2011","Norwich 005","E02005588","Total",11683,5672,6011,11622,61,89,323.94,36.1
"2011","Norwich 006","E02005589","Total",11504,5675,5829,11499,5,79,372.93,30.8
"2011","Norwich 007","E02005590","Total",9641,4881,4760,9412,229,65,236.61,40.7
"2011","Norwich 009","E02005592","Total",9297,4441,4856,9214,83,165,115.91,80.2
"2011","Norwich 010","E02005593","Total",10279,4792,5487,7060,3219,186,285.20,36.0
"2011","Norwich 011","E02005594","Total",10404,5117,5287,10290,114,163,196.93,52.8
"2011","Norwich 012","E02005595","Total",8781,4198,4583,8702,79,229,495.36,17.7
"2011","Norwich 013","E02005596","Total",9326,4454,4872,9284,42,58,319.25,29.2
"2011","Norwich 014","E02006907","Total",5136,2738,2398,5006,130,42,214.02,24.0
"2011","Norwich 015","E02006908","Total",5421,2730,2691,5327,94,52,135.44,40.0
"2011","South Norfolk 001","E02005597","Total",12463,6171,6292,12448,15,86,1238.97,10.1
"2011","South Norfolk 002","E02005598","Total",7769,3751,4018,7629,140,156,5293.77,1.5
"2011","South Norfolk 003","E02005599","Total",5691,2713,2978,5607,84,97,1091.68,5.2
"2011","South Norfolk 004","E02005600","Total",6216,3047,3169,5461,755,129,7028.46,0.9
"2011","South Norfolk 005","E02005601","Total",5714,2733,2981,5674,40,86,984.37,5.8
"2011","South Norfolk 006","E02005602","Total",10355,4958,5397,10296,59,183,7442.86,1.4
"2011","South Norfolk 007","E02005603","Total",8691,4232,4459,8640,51,125,3446.61,2.5
"2011","South Norfolk 008","E02005604","Total",8200,4026,4174,8043,157,157,7637.09,1.1
"2011","South Norfolk 009","E02005605","Total",10178,4924,5254,10057,121,183,7558.46,1.3
"2011","South Norfolk 010","E02005606","Total",5597,2793,2804,5579,18,87,10982.23,0.5
"2011","South Norfolk 011","E02005607","Total",10957,5422,5535,10904,53,134,9049.33,1.2
"2011","South Norfolk 012","E02005608","Total",7337,3586,3751,7254,83,128,11188.80,0.7
"2011","South Norfolk 013","E02005609","Total",6841,3355,3486,6805,36,62,4708.55,1.5
"2011","South Norfolk 014","E02005610","Total",7981,3956,4025,7897,84,108,12065.21,0.7
"2011","South Norfolk 015","E02005611","Total",10022,4848,5174,9925,97,83,1054.29,9.5
"2011","Babergh 001","E02006227","Total",6065,3002,3063,5925,140,127,10000.43,0.6
"2011","Babergh 002","E02006228","Total",5758,2879,2879,5718,40,93,5486.82,1.0
"2011","Babergh 003","E02006229","Total",5667,2764,2903,5613,54,72,2780.98,2.0
"2011","Babergh 004","E02006230","Total",10444,5081,5363,10372,72,182,6037.63,1.7
"2011","Babergh 005","E02006231","Total",8350,4106,4244,8205,145,132,4903.46,1.7
"2011","Babergh 006","E02006232","Total",5674,2809,2865,5650,24,116,5798.36,1.0
"2011","Babergh 007","E02006233","Total",11170,5328,5842,10941,229,106,699.51,16.0
"2011","Babergh 008","E02006234","Total",8908,4388,4520,8773,135,108,649.03,13.7
"2011","Babergh 009","E02006235","Total",7937,3902,4035,7855,82,257,11535.68,0.7
"2011","Babergh 010","E02006236","Total",10041,4981,5060,9979,62,198,5707.18,1.8
"2011","Babergh 011","E02006237","Total",7726,3764,3962,7139,587,190,5778.58,1.3
"2011","Forest Heath 001","E02006238","Total",9636,4819,4817,9571,65,54,7563.59,1.3
"2011","Forest Heath 002","E02006239","Total",6558,3506,3052,5500,1058,37,5073.32,1.3
"2011","Forest Heath 003","E02006240","Total",8680,4436,4244,8509,171,57,10556.18,0.8
"2011","Forest Heath 004","E02006241","Total",8688,4326,4362,8618,70,78,1156.28,7.5
"2011","Forest Heath 005","E02006242","Total",7611,3831,3780,7598,13,87,10778.06,0.7
"2011","Forest Heath 006","E02006243","Total",8996,4489,4507,8930,66,99,1671.98,5.4
"2011","Forest Heath 008","E02006826","Total",9579,4746,4833,9449,130,59,971.65,9.9
"2011","Ipswich 001","E02006245","Total",8039,3905,4134,8037,2,52,363.87,22.1
"2011","Ipswich 002","E02006246","Total",7463,3664,3799,7419,44,101,175.35,42.6
"2011","Ipswich 003","E02006247","Total",8879,4414,4465,8879,0,48,260.30,34.1
"2011","Ipswich 004","E02006248","Total",8324,4053,4271,8272,52,114,264.77,31.4
"2011","Ipswich 005","E02006249","Total",7876,3836,4040,7608,268,214,393.76,20.0
"2011","Ipswich 006","E02006250","Total",9938,5270,4668,9428,510,61,117.16,84.8
"2011","Ipswich 007","E02006251","Total",9700,4996,4704,9108,592,121,189.22,51.3
"2011","Ipswich 008","E02006252","Total",9134,4420,4714,8964,170,73,162.66,56.2
"2011","Ipswich 009","E02006253","Total",7055,3490,3565,7003,52,104,244.43,28.9
"2011","Ipswich 010","E02006254","Total",8826,4525,4301,8729,97,37,342.37,25.8
"2011","Ipswich 011","E02006255","Total",7799,4037,3762,7787,12,56,189.54,41.1
"2011","Ipswich 012","E02006256","Total",8632,4344,4288,8406,226,66,189.21,45.6
"2011","Ipswich 013","E02006257","Total",6660,3240,3420,6645,15,36,121.66,54.7
"2011","Ipswich 014","E02006258","Total",8991,4388,4603,8954,37,64,413.31,21.8
"2011","Ipswich 015","E02006259","Total",7276,3569,3707,7238,38,61,196.99,36.9
"2011","Ipswich 016","E02006260","Total",8792,4277,4515,8785,7,46,316.86,27.7
"2011","Mid Suffolk 001","E02006261","Total",7689,3756,3933,7564,125,126,11438.17,0.7
"2011","Mid Suffolk 002","E02006262","Total",8659,4272,4387,8610,49,175,11659.27,0.7
"2011","Mid Suffolk 003","E02006263","Total",7278,3643,3635,7278,0,142,15095.51,0.5
"2011","Mid Suffolk 004","E02006264","Total",8156,3986,4170,8135,21,185,5098.04,1.6
"2011","Mid Suffolk 005","E02006265","Total",6956,3467,3489,6942,14,116,6979.18,1.0
"2011","Mid Suffolk 006","E02006266","Total",9129,4497,4632,9127,2,169,6788.93,1.3
"2011","Mid Suffolk 007","E02006267","Total",8381,4152,4229,8373,8,193,14541.67,0.6
"2011","Mid Suffolk 008","E02006268","Total",6278,2933,3345,6174,104,62,210.80,29.8
"2011","Mid Suffolk 009","E02006269","Total",6946,3411,3535,6743,203,134,4378.44,1.6
"2011","Mid Suffolk 010","E02006270","Total",11366,5616,5750,11334,32,103,960.99,11.8
"2011","Mid Suffolk 011","E02006271","Total",8492,4553,3939,7671,821,132,5401.63,1.6
"2011","Mid Suffolk 012","E02006272","Total",7401,3638,3763,7303,98,81,4554.48,1.6
"2011","St Edmundsbury 001","E02006273","Total",6330,3139,3191,6311,19,101,6685.58,0.9
"2011","St Edmundsbury 002","E02006274","Total",7197,3829,3368,6401,796,115,11708.83,0.6
"2011","St Edmundsbury 003","E02006275","Total",7201,3529,3672,7195,6,46,181.26,39.7
"2011","St Edmundsbury 004","E02006276","Total",6562,3236,3326,6442,120,129,7111.25,0.9
"2011","St Edmundsbury 005","E02006277","Total",7968,3997,3971,7959,9,121,318.91,25.0
"2011","St Edmundsbury 006","E02006278","Total",8428,4220,4208,8258,170,135,281.82,29.9
"2011","St Edmundsbury 007","E02006279","Total",9053,4401,4652,9021,32,139,300.06,30.2
"2011","St Edmundsbury 008","E02006280","Total",9308,4557,4751,9008,300,178,16149.47,0.6
"2011","St Edmundsbury 009","E02006281","Total",8463,4064,4399,8248,215,135,618.49,13.7
"2011","St Edmundsbury 010","E02006282","Total",6204,3027,3177,6173,31,129,10287.31,0.6
"2011","St Edmundsbury 011","E02006283","Total",7253,4121,3132,6023,1230,104,10956.27,0.7
"2011","St Edmundsbury 012","E02006284","Total",7796,3849,3947,7753,43,65,226.72,34.4
"2011","St Edmundsbury 013","E02006285","Total",7974,3959,4015,7916,58,57,436.79,18.3
"2011","St Edmundsbury 014","E02006286","Total",11271,5666,5605,11234,37,65,433.65,26.0
"2011","Suffolk Coastal 001","E02006287","Total",5943,2908,3035,5838,105,141,18497.46,0.3
"2011","Suffolk Coastal 002","E02006288","Total",8865,4288,4577,8535,330,222,15674.91,0.6
"2011","Suffolk Coastal 003","E02006289","Total",8273,3970,4303,8196,77,113,7683.78,1.1
"2011","Suffolk Coastal 004","E02006290","Total",8136,3849,4287,7965,171,97,3493.52,2.3
"2011","Suffolk Coastal 005","E02006291","Total",7039,3386,3653,6988,51,133,2238.85,3.1
"2011","Suffolk Coastal 006","E02006292","Total",6543,3226,3317,6505,38,185,8762.60,0.7
"2011","Suffolk Coastal 007","E02006293","Total",10705,5662,5043,9783,922,168,20963.03,0.5
"2011","Suffolk Coastal 008","E02006294","Total",8096,3759,4337,7920,176,165,502.75,16.1
"2011","Suffolk Coastal 009","E02006295","Total",9295,4521,4774,9260,35,127,639.10,14.5
"2011","Suffolk Coastal 010","E02006296","Total",12773,6308,6465,12695,78,258,2999.58,4.3
"2011","Suffolk Coastal 011","E02006297","Total",8018,3987,4031,7965,53,191,2996.43,2.7
"2011","Suffolk Coastal 012","E02006298","Total",8865,4401,4464,8799,66,115,3285.14,2.7
"2011","Suffolk Coastal 013","E02006299","Total",8344,3952,4392,8234,110,139,662.95,12.6
"2011","Suffolk Coastal 014","E02006300","Total",7507,3601,3906,7507,0,65,509.53,14.7
"2011","Suffolk Coastal 015","E02006301","Total",5896,2845,3051,5601,295,79,246.80,23.9
"2011","Waveney 001","E02006302","Total",6968,3631,3337,6454,514,92,3739.18,1.9
"2011","Waveney 002","E02006303","Total",7649,3672,3977,7598,51,51,208.26,36.7
"2011","Waveney 003","E02006304","Total",7468,3629,3839,7407,61,59,324.66,23.0
"2011","Waveney 004","E02006305","Total",9224,4512,4712,9200,24,68,143.60,64.2
"2011","Waveney 005","E02006306","Total",7217,3568,3649,7174,43,51,300.54,24.0
"2011","Waveney 006","E02006307","Total",7382,3565,3817,7275,107,82,297.28,24.8
"2011","Waveney 007","E02006308","Total",7198,3581,3617,6937,261,68,215.60,33.4
"2011","Waveney 008","E02006309","Total",6800,3205,3595,6691,109,45,193.55,35.1
"2011","Waveney 009","E02006310","Total",8079,3887,4192,8007,72,78,823.51,9.8
"2011","Waveney 010","E02006311","Total",8219,3875,4344,8091,128,69,762.06,10.8
"2011","Waveney 011","E02006312","Total",8762,4308,4454,8758,4,114,7670.73,1.1
"2011","Waveney 012","E02006313","Total",10139,4922,5217,10110,29,106,1484.37,6.8
"2011","Waveney 013","E02006314","Total",7369,3601,3768,7229,140,91,8523.05,0.9
"2011","Waveney 014","E02006315","Total",5904,2776,3128,5788,116,88,7709.04,0.8
"2011","Waveney 015","E02006316","Total",6876,3289,3587,6800,76,77,4572.83,1.5
"2011","Camden 001","E02000166","Total",7924,3689,4235,7916,8,146,302.39,26.2
"2011","Camden 002","E02000167","Total",7944,3880,4064,7869,75,179,208.13,38.2
"2011","Camden 003","E02000168","Total",8172,3928,4244,8040,132,101,68.06,120.1
"2011","Camden 004","E02000169","Total",7637,3665,3972,6981,656,144,112.26,68.0
"2011","Camden 005","E02000170","Total",8338,4134,4204,8293,45,103,77.13,108.1
"2011","Camden 006","E02000171","Total",7818,3791,4027,7789,29,103,52.14,149.9
"2011","Camden 007","E02000172","Total",10147,4892,5255,9919,228,96,66.89,151.7
"2011","Camden 008","E02000173","Total",7675,3759,3916,7565,110,90,77.87,98.6
"2011","Camden 009","E02000174","Total",8714,4108,4606,8703,11,87,54.57,159.7
"2011","Camden 010","E02000175","Total",8848,4272,4576,8846,2,70,69.16,127.9
"2011","Camden 011","E02000176","Total",6373,3111,3262,6289,84,58,39.78,160.2
"2011","Camden 012","E02000177","Total",8948,4242,4706,8863,85,96,52.36,170.9
"2011","Camden 013","E02000178","Total",8857,4403,4454,8823,34,70,56.18,157.7
"2011","Camden 014","E02000179","Total",6329,2980,3349,6305,24,93,38.25,165.5
"2011","Camden 015","E02000180","Total",8202,4066,4136,7662,540,61,48.54,169.0
"2011","Camden 016","E02000181","Total",7708,3657,4051,7703,5,65,54.09,142.5
"2011","Camden 017","E02000182","Total",6697,3100,3597,6638,59,127,79.78,83.9
"2011","Camden 018","E02000183","Total",7913,3864,4049,7909,4,137,77.17,102.5
"2011","Camden 019","E02000184","Total",8882,4342,4540,8726,156,79,66.48,133.6
"2011","Camden 020","E02000185","Total",8290,3902,4388,8213,77,89,47.22,175.6
"2011","Camden 021","E02000186","Total",6687,3449,3238,6491,196,98,100.33,66.7
"2011","Camden 022","E02000187","Total",8155,3881,4274,8064,91,67,96.84,84.2
"2011","Camden 023","E02000188","Total",8322,4250,4072,7939,383,64,50.79,163.9
"2011","Camden 024","E02000189","Total",5944,2986,2958,5407,537,54,29.77,199.7
"2011","Camden 025","E02000190","Total",7530,3738,3792,5914,1616,48,37.05,203.2
"2011","Camden 026","E02000191","Total",7497,4008,3489,5545,1952,77,64.21,116.8
"2011","Camden 027","E02000192","Total",7157,3771,3386,7021,136,61,43.24,165.5
"2011","Camden 028","E02000193","Total",7630,4017,3613,7010,620,67,108.92,70.1
"2011","City of London 001","E02000001","Total",7375,4091,3284,7187,188,78,289.78,25.5
"2011","Hackney 001","E02000345","Total",8838,4448,4390,8828,10,154,61.21,144.4
"2011","Hackney 002","E02000346","Total",6092,3016,3076,6021,71,48,58.26,104.6
"2011","Hackney 003","E02000347","Total",7956,3960,3996,7884,72,106,68.58,116.0
"2011","Hackney 004","E02000348","Total",8120,4031,4089,8107,13,117,55.85,145.4
"2011","Hackney 006","E02000350","Total",9502,4716,4786,9474,28,104,56.66,167.7
"2011","Hackney 007","E02000351","Total",8523,4303,4220,8441,82,57,52.27,163.1
"2011","Hackney 008","E02000352","Total",6883,3225,3658,6833,50,73,76.27,90.2
"2011","Hackney 009","E02000353","Total",7786,3751,4035,7774,12,74,55.86,139.4
"2011","Hackney 010","E02000354","Total",9502,4765,4737,9449,53,42,79.33,119.8
"2011","Hackney 011","E02000355","Total",8485,4202,4283,8325,160,72,65.62,129.3
"2011","Hackney 012","E02000356","Total",7346,3633,3713,7288,58,46,40.30,182.3
"2011","Hackney 013","E02000357","Total",6339,3019,3320,6339,0,54,152.27,41.6
"2011","Hackney 014","E02000358","Total",11058,5509,5549,11047,11,65,61.64,179.4
"2011","Hackney 015","E02000359","Total",6581,3179,3402,6569,12,58,43.67,150.7
"2011","Hackney 016","E02000360","Total",11292,5492,5800,11292,0,95,54.63,206.7
"2011","Hackney 017","E02000361","Total",7640,3808,3832,7632,8,39,59.42,128.6
"2011","Hackney 018","E02000362","Total",6363,3165,3198,6266,97,47,129.54,49.1
"2011","Hackney 019","E02000363","Total",10845,5305,5540,10845,0,103,59.64,181.8
"2011","Hackney 020","E02000364","Total",8867,4399,4468,8848,19,96,66.43,133.5
"2011","Hackney 021","E02000365","Total",12764,6457,6307,12708,56,68,96.48,132.3
"2011","Hackney 022","E02000366","Total",8514,4141,4373,8396,118,99,64.35,132.3
"2011","Hackney 023","E02000367","Total",9741,4699,5042,9622,119,53,73.89,131.8
"2011","Hackney 024","E02000368","Total",9614,4697,4917,9601,13,85,63.45,151.5
"2011","Hackney 025","E02000369","Total",11594,5889,5705,11560,34,99,65.03,178.3
"2011","Hackney 026","E02000370","Total",8301,4262,4039,8292,9,97,48.80,170.1
"2011","Hackney 027","E02000371","Total",12369,6510,5859,11642,727,98,99.73,124.0
"2011","Hackney 028","E02006918","Total",7611,3724,3887,7611,0,80,51.89,146.7
"2011","Hackney 029","E02006921","Total",7744,3724,4020,7739,5,92,45.28,171.0
"2011","Hammersmith and Fulham 001","E02000372","Total",9175,4350,4825,8831,344,49,344.06,26.7
"2011","Hammersmith and Fulham 002","E02000373","Total",6658,3099,3559,6658,0,54,40.76,163.3
"2011","Hammersmith and Fulham 003","E02000374","Total",6731,3218,3513,6712,19,73,49.66,135.5
"2011","Hammersmith and Fulham 004","E02000375","Total",7028,3422,3606,6998,30,62,74.88,93.9
"2011","Hammersmith and Fulham 005","E02000376","Total",6915,3523,3392,6890,25,50,40.99,168.7
"2011","Hammersmith and Fulham 006","E02000377","Total",8169,4098,4071,7933,236,88,44.36,184.2
"2011","Hammersmith and Fulham 007","E02000378","Total",6534,3177,3357,6514,20,78,29.42,222.1
"2011","Hammersmith and Fulham 008","E02000379","Total",7581,3771,3810,7411,170,126,67.88,111.7
"2011","Hammersmith and Fulham 009","E02000380","Total",5863,2972,2891,5811,52,81,35.23,166.4
"2011","Hammersmith and Fulham 010","E02000381","Total",7768,3710,4058,7682,86,137,55.27,140.5
"2011","Hammersmith and Fulham 011","E02000382","Total",6167,3119,3048,6146,21,121,61.66,100.0
"2011","Hammersmith and Fulham 012","E02000383","Total",9432,4600,4832,9300,132,93,60.05,157.1
"2011","Hammersmith and Fulham 013","E02000384","Total",7320,3605,3715,7120,200,63,78.19,93.6
"2011","Hammersmith and Fulham 014","E02000385","Total",6162,3123,3039,6142,20,38,39.98,154.1
"2011","Hammersmith and Fulham 015","E02000386","Total",8136,4046,4090,8117,19,61,43.75,186.0
"2011","Hammersmith and Fulham 016","E02000387","Total",6272,3095,3177,6240,32,41,40.79,153.8
"2011","Hammersmith and Fulham 017","E02000388","Total",8202,3965,4237,8151,51,73,53.17,154.3
"2011","Hammersmith and Fulham 018","E02000389","Total",8255,3954,4301,8248,7,152,62.83,131.4
"2011","Hammersmith and Fulham 019","E02000390","Total",6448,3160,3288,6442,6,42,34.78,185.4
"2011","Hammersmith and Fulham 020","E02000391","Total",7729,3802,3927,7712,17,222,66.52,116.2
"2011","Hammersmith and Fulham 021","E02000392","Total",9578,4498,5080,9537,41,118,55.33,173.1
"2011","Hammersmith and Fulham 022","E02000393","Total",6031,2839,3192,6025,6,86,35.61,169.4
"2011","Hammersmith and Fulham 023","E02000394","Total",7755,3680,4075,7448,307,113,65.84,117.8
"2011","Hammersmith and Fulham 024","E02000395","Total",5951,2862,3089,5951,0,183,96.88,61.4
"2011","Hammersmith and Fulham 025","E02000396","Total",6633,3226,3407,6633,0,123,62.51,106.1
"2011","Haringey 001","E02000397","Total",7815,3896,3919,7798,17,55,56.39,138.6
"2011","Haringey 002","E02000398","Total",7123,3629,3494,6999,124,63,119.14,59.8
"2011","Haringey 004","E02000400","Total",7668,3757,3911,7648,20,75,133.39,57.5
"2011","Haringey 005","E02000401","Total",6734,3151,3583,6734,0,59,74.66,90.2
"2011","Haringey 006","E02000402","Total",6697,3080,3617,6697,0,56,95.06,70.5
"2011","Haringey 007","E02000403","Total",7199,3600,3599,7194,5,53,85.11,84.6
"2011","Haringey 008","E02000404","Total",7315,3621,3694,7304,11,58,64.10,114.1
"2011","Haringey 009","E02000405","Total",6548,3237,3311,6541,7,135,178.20,36.7
"2011","Haringey 010","E02000406","Total",7025,3380,3645,7025,0,59,45.81,153.4
"2011","Haringey 011","E02000407","Total",7312,3624,3688,7239,73,59,52.20,140.1
"2011","Haringey 012","E02000408","Total",7612,3721,3891,7577,35,71,51.79,147.0
"2011","Haringey 013","E02000409","Total",6527,3239,3288,6470,57,66,69.41,94.0
"2011","Haringey 014","E02000410","Total",6693,3240,3453,6636,57,142,75.20,89.0
"2011","Haringey 015","E02000411","Total",7452,3762,3690,7450,2,70,139.36,53.5
"2011","Haringey 016","E02000412","Total",6914,3404,3510,6760,154,56,77.16,89.6
"2011","Haringey 017","E02000413","Total",7500,3524,3976,7408,92,141,121.92,61.5
"2011","Haringey 018","E02000414","Total",7171,3652,3519,7156,15,53,40.94,175.2
"2011","Haringey 019","E02000415","Total",6845,3494,3351,6811,34,59,70.43,97.2
"2011","Haringey 020","E02000416","Total",7490,3671,3819,7482,8,55,62.87,119.1
"2011","Haringey 021","E02000417","Total",6676,3250,3426,6584,92,158,105.93,63.0
"2011","Haringey 022","E02000418","Total",5509,2603,2906,5509,0,129,71.32,77.2
"2011","Haringey 023","E02000419","Total",8108,4151,3957,8100,8,50,64.22,126.3
"2011","Haringey 024","E02000420","Total",7432,3689,3743,7425,7,53,57.71,128.8
"2011","Haringey 025","E02000421","Total",7148,3482,3666,6958,190,62,78.39,91.2
"2011","Haringey 026","E02000422","Total",7825,4008,3817,7783,42,75,54.25,144.2
"2011","Haringey 027","E02000423","Total",6813,3527,3286,6709,104,46,55.48,122.8
"2011","Haringey 028","E02000424","Total",7198,3556,3642,7056,142,72,66.60,108.1
"2011","Haringey 029","E02000425","Total",7256,3652,3604,7251,5,107,54.09,134.1
"2011","Haringey 030","E02000426","Total",6731,3278,3453,6650,81,141,222.91,30.2
"2011","Haringey 031","E02000427","Total",6854,3548,3306,6828,26,43,107.39,63.8
"2011","Haringey 032","E02000428","Total",7022,3526,3496,7014,8,58,59.66,117.7
"2011","Haringey 033","E02000429","Total",6852,3404,3448,6803,49,113,97.97,69.9
"2011","Haringey 034","E02000430","Total",7417,3733,3684,7408,9,90,65.87,112.6
"2011","Haringey 035","E02000431","Total",6685,3356,3329,6531,154,89,60.99,109.6
"2011","Haringey 036","E02000432","Total",6454,3221,3233,6421,33,54,53.59,120.4
"2011","Haringey 037","E02006794","Total",7306,3558,3748,7277,29,49,69.34,105.4
"2011","Islington 001","E02000554","Total",9182,4387,4795,9132,50,101,63.70,144.1
"2011","Islington 002","E02000555","Total",9408,4449,4959,9355,53,99,59.62,157.8
"2011","Islington 003","E02000556","Total",10008,4922,5086,9990,18,45,65.11,153.7
"2011","Islington 004","E02000557","Total",8124,3878,4246,8066,58,53,70.84,114.7
"2011","Islington 005","E02000558","Total",8870,4363,4507,8693,177,70,48.12,184.3
"2011","Islington 006","E02000559","Total",8778,4496,4282,8778,0,73,57.68,152.2
"2011","Islington 007","E02000560","Total",7076,3614,3462,6888,188,59,50.32,140.6
"2011","Islington 008","E02000561","Total",7746,3780,3966,7632,114,143,61.35,126.3
"2011","Islington 009","E02000562","Total",7934,3834,4100,7814,120,116,64.81,122.4
"2011","Islington 010","E02000563","Total",8486,4075,4411,8028,458,73,57.98,146.4
"2011","Islington 011","E02000564","Total",10488,5184,5304,10465,23,56,80.77,129.9
"2011","Islington 012","E02000565","Total",8187,3904,4283,7974,213,70,51.26,159.7
"2011","Islington 013","E02000566","Total",8164,3992,4172,8164,0,107,69.99,116.6
"2011","Islington 014","E02000567","Total",10358,4888,5470,10358,0,81,66.42,155.9
"2011","Islington 015","E02000568","Total",9625,4945,4680,8661,964,68,90.29,106.6
"2011","Islington 016","E02000569","Total",10022,4769,5253,10015,7,89,70.04,143.1
"2011","Islington 017","E02000570","Total",8615,4303,4312,8595,20,120,60.12,143.3
"2011","Islington 018","E02000571","Total",8031,3948,4083,7998,33,65,49.79,161.3
"2011","Islington 019","E02000572","Total",8571,4071,4500,8108,463,85,45.86,186.9
"2011","Islington 020","E02000573","Total",8674,4368,4306,8507,167,102,72.51,119.6
"2011","Islington 021","E02000574","Total",8501,4198,4303,7708,793,56,60.81,139.8
"2011","Islington 022","E02000575","Total",11889,6226,5663,10418,1471,121,92.96,127.9
"2011","Islington 023","E02000576","Total",9388,4811,4577,8787,601,79,75.60,124.2
"2011","Kensington and Chelsea 001","E02000577","Total",7199,3523,3676,7195,4,74,87.12,82.6
"2011","Kensington and Chelsea 002","E02000578","Total",5798,2752,3046,5706,92,44,51.36,112.9
"2011","Kensington and Chelsea 003","E02000579","Total",8616,4091,4525,8570,46,123,61.05,141.1
"2011","Kensington and Chelsea 004","E02000580","Total",8655,4246,4409,8619,36,86,39.62,218.5
"2011","Kensington and Chelsea 005","E02000581","Total",7298,3415,3883,7292,6,76,43.14,169.2
"2011","Kensington and Chelsea 006","E02000582","Total",7659,3758,3901,7317,342,146,48.79,157.0
"2011","Kensington and Chelsea 007","E02000583","Total",7303,3485,3818,7290,13,247,57.57,126.9
"2011","Kensington and Chelsea 008","E02000584","Total",8178,3972,4206,7952,226,187,91.16,89.7
"2011","Kensington and Chelsea 009","E02000585","Total",8384,4094,4290,8361,23,176,90.78,92.4
"2011","Kensington and Chelsea 010","E02000586","Total",7769,3912,3857,7566,203,200,52.53,147.9
"2011","Kensington and Chelsea 011","E02000587","Total",7523,3743,3780,7488,35,242,52.24,144.0
"2011","Kensington and Chelsea 012","E02000588","Total",8159,4225,3934,8158,1,191,76.71,106.4
"2011","Kensington and Chelsea 013","E02000589","Total",8444,4520,3924,8138,306,103,37.08,227.7
"2011","Kensington and Chelsea 014","E02000590","Total",7015,3330,3685,7010,5,169,46.05,152.3
"2011","Kensington and Chelsea 015","E02000591","Total",6769,3477,3292,6648,121,77,36.08,187.6
"2011","Kensington and Chelsea 016","E02000592","Total",6761,3369,3392,6724,37,136,56.71,119.2
"2011","Kensington and Chelsea 017","E02000593","Total",7624,3908,3716,7601,23,101,49.83,153.0
"2011","Kensington and Chelsea 018","E02000594","Total",7252,3625,3627,6958,294,245,77.36,93.7
"2011","Kensington and Chelsea 019","E02000595","Total",7331,3472,3859,7107,224,187,63.51,115.4
"2011","Kensington and Chelsea 020","E02000596","Total",7782,3900,3882,7119,663,167,54.75,142.1
"2011","Kensington and Chelsea 021","E02000597","Total",7130,3377,3753,7120,10,116,39.51,180.5
"2011","Lambeth 002","E02000619","Total",8054,4069,3985,7987,67,75,54.84,146.9
"2011","Lambeth 003","E02000620","Total",9370,4895,4475,9350,20,90,72.64,129.0
"2011","Lambeth 004","E02000621","Total",10429,5649,4780,10271,158,77,72.88,143.1
"2011","Lambeth 005","E02000622","Total",8094,4277,3817,8031,63,83,77.85,104.0
"2011","Lambeth 006","E02000623","Total",7990,4049,3941,7979,11,102,45.87,174.2
"2011","Lambeth 007","E02000624","Total",7976,4025,3951,7933,43,80,57.54,138.6
"2011","Lambeth 008","E02000625","Total",8361,4239,4122,8310,51,92,55.53,150.6
"2011","Lambeth 009","E02000626","Total",8301,4067,4234,8256,45,94,55.58,149.4
"2011","Lambeth 010","E02000627","Total",9571,4837,4734,9496,75,87,52.63,181.9
"2011","Lambeth 011","E02000628","Total",9731,4874,4857,9676,55,93,65.58,148.4
"2011","Lambeth 012","E02000629","Total",9033,4570,4463,9004,29,82,64.15,140.8
"2011","Lambeth 013","E02000630","Total",7266,3609,3657,7265,1,88,67.86,107.1
"2011","Lambeth 014","E02000631","Total",8832,4290,4542,8798,34,114,106.47,83.0
"2011","Lambeth 015","E02000632","Total",9516,4829,4687,9484,32,41,52.82,180.2
"2011","Lambeth 016","E02000633","Total",8642,4286,4356,8581,61,89,63.14,136.9
"2011","Lambeth 017","E02000634","Total",6846,3392,3454,6740,106,74,52.09,131.4
"2011","Lambeth 018","E02000635","Total",9157,4568,4589,9138,19,88,124.27,73.7
"2011","Lambeth 019","E02000636","Total",7639,3829,3810,7613,26,141,92.39,82.7
"2011","Lambeth 020","E02000637","Total",8687,4427,4260,8637,50,59,58.43,148.7
"2011","Lambeth 021","E02000638","Total",9898,4959,4939,9509,389,72,68.51,144.5
"2011","Lambeth 022","E02000639","Total",8119,3925,4194,8090,29,82,58.43,139.0
"2011","Lambeth 023","E02000640","Total",9123,4336,4787,9110,13,87,81.82,111.5
"2011","Lambeth 024","E02000641","Total",8779,4138,4641,8638,141,88,61.01,143.9
"2011","Lambeth 025","E02000642","Total",9628,4692,4936,9617,11,117,108.41,88.8
"2011","Lambeth 026","E02000643","Total",8369,4014,4355,8347,22,106,70.08,119.4
"2011","Lambeth 027","E02000644","Total",8620,4213,4407,8524,96,115,90.45,95.3
"2011","Lambeth 028","E02000645","Total",9020,4424,4596,8992,28,148,113.32,79.6
"2011","Lambeth 029","E02000646","Total",9121,4511,4610,8983,138,99,94.79,96.2
"2011","Lambeth 030","E02000647","Total",8483,4179,4304,8325,158,107,96.71,87.7
"2011","Lambeth 031","E02000648","Total",7791,3579,4212,7683,108,67,70.42,110.6
"2011","Lambeth 032","E02000649","Total",11181,5567,5614,10973,208,78,103.57,108.0
"2011","Lambeth 033","E02000650","Total",7424,3472,3952,7424,0,80,77.19,96.2
"2011","Lambeth 034","E02000651","Total",8591,4260,4331,8456,135,97,111.98,76.7
"2011","Lambeth 035","E02000652","Total",7363,3633,3730,7324,39,87,68.73,107.1
"2011","Lambeth 036","E02006801","Total",8081,4238,3843,7557,524,107,114.16,70.8
"2011","Lewisham 001","E02000653","Total",8544,4308,4236,8525,19,99,67.63,126.3
"2011","Lewisham 002","E02000654","Total",8059,3856,4203,8055,4,102,94.57,85.2
"2011","Lewisham 003","E02000655","Total",8208,4069,4139,7887,321,87,97.84,83.9
"2011","Lewisham 005","E02000657","Total",9078,4540,4538,8566,512,64,87.38,103.9
"2011","Lewisham 006","E02000658","Total",8314,4310,4004,8295,19,116,77.40,107.4
"2011","Lewisham 007","E02000659","Total",7697,3674,4023,7611,86,98,102.58,75.0
"2011","Lewisham 008","E02000660","Total",8078,4018,4060,7945,133,61,81.24,99.4
"2011","Lewisham 009","E02000661","Total",6342,3116,3226,6275,67,62,128.67,49.3
"2011","Lewisham 010","E02000662","Total",8100,3859,4241,8093,7,90,76.99,105.2
"2011","Lewisham 011","E02000663","Total",7194,3761,3433,7186,8,91,65.63,109.6
"2011","Lewisham 012","E02000664","Total",9928,5062,4866,9797,131,73,141.36,70.2
"2011","Lewisham 013","E02000665","Total",7916,3950,3966,7907,9,64,80.03,98.9
"2011","Lewisham 014","E02000666","Total",7321,3423,3898,7214,107,72,95.19,76.9
"2011","Lewisham 015","E02000667","Total",6534,3101,3433,6526,8,73,72.73,89.8
"2011","Lewisham 016","E02000668","Total",6657,3309,3348,6647,10,96,100.86,66.0
"2011","Lewisham 017","E02000669","Total",7518,3771,3747,7403,115,50,64.23,117.0
"2011","Lewisham 018","E02000670","Total",6539,3143,3396,6522,17,49,62.15,105.2
"2011","Lewisham 019","E02000671","Total",8403,4098,4305,8375,28,89,99.43,84.5
"2011","Lewisham 020","E02000672","Total",8377,4313,4064,8206,171,70,115.91,72.3
"2011","Lewisham 021","E02000673","Total",8007,4060,3947,7988,19,96,106.02,75.5
"2011","Lewisham 022","E02000674","Total",8015,3773,4242,7944,71,123,81.75,98.0
"2011","Lewisham 023","E02000675","Total",8204,3953,4251,8165,39,94,143.34,57.2
"2011","Lewisham 024","E02000676","Total",7713,3774,3939,7694,19,81,74.58,103.4
"2011","Lewisham 025","E02000677","Total",7199,3561,3638,7103,96,116,105.02,68.5
"2011","Lewisham 026","E02000678","Total",6087,2840,3247,6087,0,49,103.33,58.9
"2011","Lewisham 027","E02000679","Total",7905,3931,3974,7867,38,103,93.88,84.2
"2011","Lewisham 028","E02000680","Total",6847,3380,3467,6750,97,81,76.75,89.2
"2011","Lewisham 029","E02000681","Total",8094,3853,4241,8094,0,76,135.38,59.8
"2011","Lewisham 030","E02000682","Total",8162,3856,4306,8147,15,86,119.02,68.6
"2011","Lewisham 031","E02000683","Total",6444,3023,3421,6443,1,60,95.91,67.2
"2011","Lewisham 033","E02000685","Total",7679,3627,4052,7584,95,85,96.72,79.4
"2011","Lewisham 034","E02000686","Total",6681,3132,3549,6672,9,56,173.09,38.6
"2011","Lewisham 035","E02000687","Total",7926,3966,3960,7828,98,89,77.71,102.0
"2011","Lewisham 037","E02006783","Total",7208,3333,3875,7208,0,43,93.81,76.8
"2011","Lewisham 038","E02006784","Total",7359,3434,3925,7358,1,72,144.29,51.0
"2011","Lewisham 039","E02006798","Total",7548,3780,3768,7375,173,81,82.12,91.9
"2011","Newham 001","E02000714","Total",8133,4164,3969,8131,2,79,54.94,148.0
"2011","Newham 002","E02000715","Total",7381,3829,3552,7311,70,67,42.70,172.9
"2011","Newham 003","E02000716","Total",7354,3912,3442,7239,115,58,156.50,47.0
"2011","Newham 004","E02000717","Total",8101,4305,3796,8101,0,51,49.87,162.4
"2011","Newham 005","E02000718","Total",6844,3429,3415,6840,4,52,62.50,109.5
"2011","Newham 006","E02000719","Total",8216,4243,3973,8141,75,59,69.44,118.3
"2011","Newham 007","E02000720","Total",7483,4104,3379,7469,14,90,52.47,142.6
"2011","Newham 008","E02000721","Total",9665,5243,4422,9398,267,76,58.97,163.9
"2011","Newham 009","E02000722","Total",8226,4255,3971,8085,141,52,45.23,181.9
"2011","Newham 010","E02000723","Total",10600,5779,4821,10591,9,90,71.01,149.3
"2011","Newham 011","E02000724","Total",9415,5203,4212,9349,66,57,49.70,189.4
"2011","Newham 012","E02000725","Total",8876,4512,4364,8773,103,64,79.31,111.9
"2011","Newham 013","E02000726","Total",8892,4739,4153,8874,18,68,339.92,26.2
"2011","Newham 014","E02000727","Total",8305,4710,3595,8301,4,55,39.47,210.4
"2011","Newham 015","E02000728","Total",8227,4440,3787,8227,0,69,65.56,125.5
"2011","Newham 016","E02000729","Total",7080,3712,3368,7062,18,67,70.44,100.5
"2011","Newham 017","E02000730","Total",8992,5026,3966,8956,36,67,50.34,178.6
"2011","Newham 018","E02000731","Total",10073,5718,4355,10073,0,74,58.08,173.4
"2011","Newham 019","E02000732","Total",7566,4052,3514,7560,6,47,44.14,171.4
"2011","Newham 020","E02000733","Total",9754,4899,4855,9752,2,50,74.00,131.8
"2011","Newham 021","E02000734","Total",7642,3932,3710,7640,2,58,38.04,200.9
"2011","Newham 022","E02000735","Total",7582,4089,3493,7547,35,55,54.84,138.3
"2011","Newham 023","E02000736","Total",8571,4392,4179,8531,40,63,125.50,68.3
"2011","Newham 024","E02000737","Total",9434,4763,4671,9434,0,95,84.10,112.2
"2011","Newham 025","E02000738","Total",8467,4405,4062,8466,1,56,45.94,184.3
"2011","Newham 026","E02000739","Total",6894,3529,3365,6880,14,46,45.34,152.1
"2011","Newham 027","E02000740","Total",6779,3345,3434,6768,11,80,126.32,53.7
"2011","Newham 028","E02000741","Total",8261,4183,4078,8223,38,70,75.55,109.3
"2011","Newham 029","E02000742","Total",8005,4002,4003,7952,53,46,79.10,101.2
"2011","Newham 030","E02000743","Total",7866,3926,3940,7830,36,71,62.71,125.4
"2011","Newham 031","E02000744","Total",8029,3951,4078,8025,4,66,59.84,134.2
"2011","Newham 032","E02000745","Total",8141,3961,4180,8135,6,90,72.38,112.5
"2011","Newham 033","E02000746","Total",7382,3512,3870,6908,474,93,422.55,17.5
"2011","Newham 034","E02000747","Total",10646,5554,5092,10630,16,86,189.71,56.1
"2011","Newham 035","E02000748","Total",6240,3056,3184,5954,286,45,133.17,46.9
"2011","Newham 036","E02000749","Total",8183,3957,4226,8183,0,65,141.91,57.7
"2011","Newham 037","E02000750","Total",10679,5505,5174,10670,9,84,330.77,32.3
"2011","Southwark 001","E02000807","Total",8313,4278,4035,8305,8,73,71.19,116.8
"2011","Southwark 002","E02000808","Total",9102,4712,4390,8312,790,68,104.63,87.0
"2011","Southwark 003","E02000809","Total",11711,6450,5261,11536,175,41,76.57,152.9
"2011","Southwark 004","E02000810","Total",9144,4452,4692,9131,13,62,68.65,133.2
"2011","Southwark 006","E02000812","Total",10290,5077,5213,9697,593,83,70.20,146.6
"2011","Southwark 007","E02000813","Total",8591,4162,4429,8561,30,64,89.43,96.1
"2011","Southwark 008","E02000814","Total",8652,4397,4255,8563,89,58,98.28,88.0
"2011","Southwark 009","E02000815","Total",6497,3342,3155,5774,723,87,42.09,154.4
"2011","Southwark 010","E02000816","Total",9043,4379,4664,9030,13,58,75.95,119.1
"2011","Southwark 011","E02000817","Total",6494,3153,3341,6425,69,79,66.23,98.1
"2011","Southwark 012","E02000818","Total",7534,3758,3776,7507,27,62,58.43,128.9
"2011","Southwark 013","E02000819","Total",8315,4182,4133,8301,14,63,53.69,154.9
"2011","Southwark 014","E02000820","Total",8503,4395,4108,8369,134,72,45.00,189.0
"2011","Southwark 015","E02000821","Total",8386,4131,4255,8368,18,105,71.84,116.7
"2011","Southwark 016","E02000822","Total",8111,4005,4106,8096,15,72,47.92,169.3
"2011","Southwark 017","E02000823","Total",7733,3801,3932,7726,7,74,64.40,120.1
"2011","Southwark 018","E02000824","Total",9568,4609,4959,9559,9,126,97.20,98.4
"2011","Southwark 019","E02000825","Total",9649,4702,4947,9580,69,113,53.30,181.0
"2011","Southwark 020","E02000826","Total",8888,4288,4600,8714,174,108,54.96,161.7
"2011","Southwark 021","E02000827","Total",10359,5209,5150,10170,189,112,68.11,152.1
"2011","Southwark 022","E02000828","Total",8383,4145,4238,8345,38,87,63.61,131.8
"2011","Southwark 023","E02000829","Total",10389,5303,5086,10232,157,96,79.20,131.2
"2011","Southwark 024","E02000830","Total",8870,4335,4535,8819,51,117,83.59,106.1
"2011","Southwark 025","E02000831","Total",9378,4591,4787,9281,97,86,80.59,116.4
"2011","Southwark 026","E02000832","Total",9960,4759,5201,9851,109,89,84.58,117.8
"2011","Southwark 027","E02000833","Total",7755,3575,4180,7334,421,125,82.61,93.9
"2011","Southwark 028","E02000834","Total",9199,4380,4819,9161,38,74,121.36,75.8
"2011","Southwark 029","E02000835","Total",7236,3469,3767,7194,42,89,146.01,49.6
"2011","Southwark 030","E02000836","Total",8240,3985,4255,8219,21,117,75.59,109.0
"2011","Southwark 031","E02000837","Total",9085,4390,4695,9020,65,295,238.07,38.2
"2011","Southwark 032","E02000838","Total",9180,4317,4863,9120,60,108,106.96,85.8
"2011","Southwark 033","E02000839","Total",8036,3927,4109,7869,167,120,276.19,29.1
"2011","Southwark 034","E02006802","Total",7689,3960,3729,6391,1298,104,68.98,111.5
"2011","Tower Hamlets 001","E02000864","Total",8297,4020,4277,8296,1,38,126.19,65.8
"2011","Tower Hamlets 002","E02000865","Total",7051,3474,3577,6977,74,31,46.37,152.1
"2011","Tower Hamlets 003","E02000866","Total",9662,4778,4884,9610,52,65,113.42,85.2
"2011","Tower Hamlets 004","E02000867","Total",9761,4900,4861,9761,0,67,80.92,120.6
"2011","Tower Hamlets 005","E02000868","Total",6632,3341,3291,6416,216,36,35.92,184.6
"2011","Tower Hamlets 006","E02000869","Total",5705,2956,2749,5679,26,24,32.23,177.0
"2011","Tower Hamlets 007","E02000870","Total",6477,3242,3235,6430,47,24,39.50,164.0
"2011","Tower Hamlets 008","E02000871","Total",8591,4379,4212,8591,0,55,66.90,128.4
"2011","Tower Hamlets 009","E02000872","Total",7501,3901,3600,7480,21,31,45.66,164.3
"2011","Tower Hamlets 010","E02000873","Total",8713,4315,4398,7467,1246,111,50.48,172.6
"2011","Tower Hamlets 011","E02000874","Total",7129,3632,3497,6879,250,59,34.29,207.9
"2011","Tower Hamlets 012","E02000875","Total",9440,4781,4659,9379,61,51,66.76,141.4
"2011","Tower Hamlets 013","E02000876","Total",7037,3748,3289,6900,137,45,53.86,130.7
"2011","Tower Hamlets 014","E02000877","Total",9803,4969,4834,9748,55,49,80.79,121.3
"2011","Tower Hamlets 015","E02000878","Total",10286,5492,4794,9451,835,88,63.84,161.1
"2011","Tower Hamlets 016","E02000879","Total",7634,3839,3795,7417,217,35,44.39,172.0
"2011","Tower Hamlets 017","E02000880","Total",5776,3022,2754,5634,142,26,37.23,155.1
"2011","Tower Hamlets 018","E02000881","Total",6909,3448,3461,6909,0,52,70.49,98.0
"2011","Tower Hamlets 019","E02000882","Total",8604,4340,4264,8563,41,39,57.43,149.8
"2011","Tower Hamlets 020","E02000883","Total",7950,3977,3973,7853,97,59,47.30,168.1
"2011","Tower Hamlets 021","E02000884","Total",9086,5060,4026,9021,65,59,54.55,166.6
"2011","Tower Hamlets 022","E02000885","Total",6895,3502,3393,6873,22,43,33.79,204.1
"2011","Tower Hamlets 023","E02000886","Total",7326,3931,3395,7326,0,33,48.93,149.7
"2011","Tower Hamlets 024","E02000887","Total",8660,4359,4301,8585,75,43,58.26,148.6
"2011","Tower Hamlets 025","E02000888","Total",8215,4361,3854,8210,5,30,52.70,155.9
"2011","Tower Hamlets 026","E02000889","Total",6616,3607,3009,6549,67,37,57.96,114.1
"2011","Tower Hamlets 027","E02000890","Total",5795,3152,2643,5795,0,35,56.26,103.0
"2011","Tower Hamlets 028","E02000891","Total",12678,6719,5959,12678,0,76,152.57,83.1
"2011","Tower Hamlets 030","E02000893","Total",6783,3410,3373,6783,0,41,71.83,94.4
"2011","Tower Hamlets 031","E02000894","Total",10137,5320,4817,10137,0,41,54.80,185.0
"2011","Tower Hamlets 032","E02006853","Total",7064,3680,3384,7063,1,36,49.95,141.4
"2011","Tower Hamlets 033","E02006854","Total",5883,3251,2632,5883,0,38,91.33,64.4
"2011","Wandsworth 001","E02000923","Total",7474,3721,3753,7337,137,136,107.05,69.8
"2011","Wandsworth 002","E02000924","Total",11131,5446,5685,11128,3,104,202.23,55.0
"2011","Wandsworth 003","E02000925","Total",7848,3709,4139,7811,37,101,44.19,177.6
"2011","Wandsworth 004","E02000926","Total",8936,4523,4413,8876,60,90,62.96,141.9
"2011","Wandsworth 005","E02000927","Total",6790,3257,3533,6790,0,40,45.01,150.9
"2011","Wandsworth 006","E02000928","Total",8458,4017,4441,8448,10,209,93.98,90.0
"2011","Wandsworth 007","E02000929","Total",7277,3370,3907,7277,0,53,40.30,180.6
"2011","Wandsworth 008","E02000930","Total",9676,4679,4997,9649,27,64,81.06,119.4
"2011","Wandsworth 009","E02000931","Total",8474,4177,4297,8474,0,108,79.57,106.5
"2011","Wandsworth 010","E02000932","Total",10296,5096,5200,10296,0,117,126.70,81.3
"2011","Wandsworth 011","E02000933","Total",8781,4225,4556,8760,21,266,107.47,81.7
"2011","Wandsworth 012","E02000934","Total",9105,4484,4621,9040,65,70,78.52,116.0
"2011","Wandsworth 013","E02000935","Total",6850,3078,3772,5946,904,88,142.76,48.0
"2011","Wandsworth 014","E02000936","Total",8330,3952,4378,8252,78,98,90.16,92.4
"2011","Wandsworth 015","E02000937","Total",7724,3791,3933,7711,13,223,123.39,62.6
"2011","Wandsworth 016","E02000938","Total",9546,4390,5156,9271,275,141,175.99,54.2
"2011","Wandsworth 017","E02000939","Total",7968,3890,4078,7760,208,254,72.81,109.4
"2011","Wandsworth 018","E02000940","Total",7835,3800,4035,7814,21,44,70.08,111.8
"2011","Wandsworth 019","E02000941","Total",9941,4860,5081,9841,100,192,106.05,93.7
"2011","Wandsworth 020","E02000942","Total",9665,4707,4958,9633,32,210,101.14,95.6
"2011","Wandsworth 021","E02000943","Total",8402,4192,4210,8388,14,134,70.56,119.1
"2011","Wandsworth 022","E02000944","Total",7206,3389,3817,6923,283,68,58.57,123.0
"2011","Wandsworth 023","E02000945","Total",7620,3535,4085,7044,576,98,220.99,34.5
"2011","Wandsworth 024","E02000946","Total",8795,4810,3985,7621,1174,78,106.59,82.5
"2011","Wandsworth 025","E02000947","Total",8675,4130,4545,8675,0,79,83.27,104.2
"2011","Wandsworth 026","E02000948","Total",9877,4790,5087,9818,59,88,132.73,74.4
"2011","Wandsworth 027","E02000949","Total",9805,4778,5027,9525,280,259,139.85,70.1
"2011","Wandsworth 028","E02000950","Total",7578,3656,3922,7541,37,91,85.90,88.2
"2011","Wandsworth 029","E02000951","Total",6650,3199,3451,6522,128,88,49.16,135.3
"2011","Wandsworth 030","E02000952","Total",6257,3061,3196,6205,52,125,55.86,112.0
"2011","Wandsworth 031","E02000953","Total",7084,3254,3830,6758,326,56,68.86,102.9
"2011","Wandsworth 032","E02000954","Total",6429,3117,3312,6426,3,53,45.03,142.8
"2011","Wandsworth 033","E02000955","Total",6714,3232,3482,6712,2,48,56.10,119.7
"2011","Wandsworth 034","E02000956","Total",7705,3639,4066,7664,41,66,85.71,89.9
"2011","Wandsworth 035","E02000957","Total",10589,5164,5425,10496,93,81,74.36,142.4
"2011","Wandsworth 036","E02000958","Total",8271,3974,4297,8065,206,143,89.10,92.8
"2011","Wandsworth 037","E02000959","Total",7233,3554,3679,7151,82,73,52.23,138.5
"2011","Westminster 001","E02000960","Total",6620,3113,3507,6499,121,127,92.14,71.8
"2011","Westminster 002","E02000961","Total",9442,4484,4958,9380,62,176,81.25,116.2
"2011","Westminster 003","E02000962","Total",8624,4201,4423,8614,10,120,69.38,124.3
"2011","Westminster 004","E02000963","Total",10363,4867,5496,10303,60,69,48.68,212.9
"2011","Westminster 005","E02000964","Total",12549,6063,6486,12458,91,93,50.87,246.7
"2011","Westminster 006","E02000965","Total",8627,4283,4344,8604,23,69,49.13,175.6
"2011","Westminster 007","E02000966","Total",9708,4839,4869,9661,47,215,56.02,173.3
"2011","Westminster 008","E02000967","Total",7289,3759,3530,7093,196,161,141.40,51.5
"2011","Westminster 009","E02000968","Total",14358,6993,7365,14199,159,128,60.86,235.9
"2011","Westminster 010","E02000969","Total",9329,4540,4789,9060,269,90,54.30,171.8
"2011","Westminster 011","E02000970","Total",8983,4764,4219,8916,67,131,108.41,82.9
"2011","Westminster 012","E02000971","Total",8408,4523,3885,8191,217,136,54.08,155.5
"2011","Westminster 013","E02000972","Total",8333,4708,3625,7617,716,99,129.27,64.5
"2011","Westminster 014","E02000973","Total",10090,5074,5016,10031,59,138,54.25,186.0
"2011","Westminster 015","E02000974","Total",8794,4871,3923,8448,346,188,68.92,127.6
"2011","Westminster 016","E02000975","Total",8757,4631,4126,8391,366,82,48.43,180.8
"2011","Westminster 017","E02000976","Total",9946,5156,4790,9766,180,141,46.17,215.4
"2011","Westminster 018","E02000977","Total",7490,4297,3193,6719,771,59,251.46,29.8
"2011","Westminster 019","E02000978","Total",9270,4949,4321,7862,1408,264,359.33,25.8
"2011","Westminster 020","E02000979","Total",8081,4364,3717,7317,764,163,139.19,58.1
"2011","Westminster 021","E02000980","Total",8684,4368,4316,8626,58,100,44.83,193.7
"2011","Westminster 022","E02000981","Total",8991,4546,4445,8866,125,135,36.37,247.2
"2011","Westminster 023","E02000982","Total",8226,4011,4215,8198,28,186,65.28,126.0
"2011","Westminster 024","E02000983","Total",8434,4144,4290,8389,45,101,37.76,223.4
"2011","Barking and Dagenham 001","E02000002","Total",6775,3156,3619,6724,51,49,216.15,31.3
"2011","Barking and Dagenham 002","E02000003","Total",10045,4844,5201,10033,12,104,214.15,46.9
"2011","Barking and Dagenham 003","E02000004","Total",6182,2950,3232,5937,245,53,249.28,24.8
"2011","Barking and Dagenham 004","E02000005","Total",8562,4134,4428,8562,0,71,118.81,72.1
"2011","Barking and Dagenham 006","E02000007","Total",8791,4099,4692,8672,119,68,173.58,50.6
"2011","Barking and Dagenham 007","E02000008","Total",11569,5450,6119,11564,5,118,141.99,81.5
"2011","Barking and Dagenham 008","E02000009","Total",8395,4080,4315,8376,19,75,96.06,87.4
"2011","Barking and Dagenham 009","E02000010","Total",8615,4085,4530,8615,0,63,112.12,76.8
"2011","Barking and Dagenham 010","E02000011","Total",6187,3046,3141,6086,101,74,159.39,38.8
"2011","Barking and Dagenham 011","E02000012","Total",9888,4797,5091,9879,9,108,130.03,76.0
"2011","Barking and Dagenham 012","E02000013","Total",8402,4033,4369,8396,6,70,130.46,64.4
"2011","Barking and Dagenham 013","E02000014","Total",9402,4413,4989,9319,83,54,119.27,78.8
"2011","Barking and Dagenham 014","E02000015","Total",7563,3635,3928,7549,14,80,136.18,55.5
"2011","Barking and Dagenham 015","E02000016","Total",7676,4032,3644,7670,6,63,88.62,86.6
"2011","Barking and Dagenham 016","E02000017","Total",8498,4524,3974,8468,30,89,87.65,97.0
"2011","Barking and Dagenham 017","E02000018","Total",8890,4308,4582,8884,6,63,135.78,65.5
"2011","Barking and Dagenham 018","E02000019","Total",8276,3997,4279,8234,42,78,303.77,27.2
"2011","Barking and Dagenham 019","E02000020","Total",9276,4635,4641,9274,2,93,341.93,27.1
"2011","Barking and Dagenham 020","E02000021","Total",7904,3797,4107,7798,106,76,288.04,27.4
"2011","Barking and Dagenham 021","E02000022","Total",8777,4409,4368,8684,93,74,74.89,117.2
"2011","Barking and Dagenham 022","E02000023","Total",6482,3160,3322,6482,0,49,174.52,37.1
"2011","Barking and Dagenham 023","E02006799","Total",9756,4653,5103,9695,61,82,116.37,83.8
"2011","Barnet 001","E02000024","Total",10156,4854,5302,9969,187,214,375.35,27.1
"2011","Barnet 002","E02000025","Total",7956,3823,4133,7929,27,140,240.19,33.1
"2011","Barnet 003","E02000026","Total",6313,3102,3211,6276,37,114,146.59,43.1
"2011","Barnet 004","E02000027","Total",9598,4548,5050,9499,99,119,167.45,57.3
"2011","Barnet 005","E02000028","Total",6166,3034,3132,6107,59,115,105.56,58.4
"2011","Barnet 006","E02000029","Total",8517,4137,4380,8507,10,121,168.45,50.6
"2011","Barnet 007","E02000030","Total",9130,4332,4798,9013,117,279,1457.87,6.3
"2011","Barnet 008","E02000031","Total",7294,3503,3791,7150,144,167,193.89,37.6
"2011","Barnet 009","E02000032","Total",7857,3813,4044,7825,32,137,139.78,56.2
"2011","Barnet 010","E02000033","Total",8537,4140,4397,8438,99,121,177.59,48.1
"2011","Barnet 011","E02000034","Total",8508,4059,4449,8450,58,147,155.82,54.6
"2011","Barnet 012","E02000035","Total",7965,3795,4170,7783,182,116,129.76,61.4
"2011","Barnet 013","E02000036","Total",10743,5215,5528,10689,54,183,179.47,59.9
"2011","Barnet 014","E02000037","Total",9741,4689,5052,9741,0,201,432.44,22.5
"2011","Barnet 015","E02000038","Total",10514,5220,5294,10285,229,158,176.25,59.7
"2011","Barnet 016","E02000039","Total",6675,3258,3417,6675,0,178,213.20,31.3
"2011","Barnet 017","E02000040","Total",7197,3410,3787,7094,103,150,515.51,14.0
"2011","Barnet 018","E02000041","Total",8811,4346,4465,8762,49,153,134.92,65.3
"2011","Barnet 019","E02000042","Total",10639,5241,5398,10458,181,127,121.25,87.7
"2011","Barnet 020","E02000043","Total",7696,3728,3968,7616,80,139,146.94,52.4
"2011","Barnet 021","E02000044","Total",8071,3772,4299,8071,0,123,110.74,72.9
"2011","Barnet 022","E02000045","Total",10237,5002,5235,10226,11,119,173.50,59.0
"2011","Barnet 023","E02000046","Total",7063,3445,3618,7000,63,86,96.93,72.9
"2011","Barnet 024","E02000047","Total",11373,5436,5937,11207,166,102,142.24,80.0
"2011","Barnet 025","E02000048","Total",9817,4713,5104,9817,0,187,308.42,31.8
"2011","Barnet 026","E02000049","Total",8503,4002,4501,8503,0,107,78.84,107.9
"2011","Barnet 027","E02000050","Total",10064,4863,5201,10052,12,124,212.05,47.5
"2011","Barnet 028","E02000051","Total",8647,4168,4479,8569,78,203,144.87,59.7
"2011","Barnet 029","E02000052","Total",9698,4695,5003,9698,0,129,96.92,100.1
"2011","Barnet 030","E02000053","Total",8697,4420,4277,8250,447,134,155.02,56.1
"2011","Barnet 031","E02000054","Total",7206,3552,3654,7175,31,112,150.02,48.0
"2011","Barnet 032","E02000055","Total",11130,5514,5616,10893,237,163,144.02,77.3
"2011","Barnet 033","E02000056","Total",9212,4319,4893,9042,170,245,322.71,28.5
"2011","Barnet 034","E02000057","Total",7484,3697,3787,7437,47,144,109.45,68.4
"2011","Barnet 035","E02000058","Total",10220,4805,5415,10177,43,234,181.33,56.4
"2011","Barnet 036","E02000059","Total",10459,5189,5270,10442,17,99,219.36,47.7
"2011","Barnet 037","E02000060","Total",10920,5364,5556,10693,227,332,123.27,88.6
"2011","Barnet 038","E02000061","Total",8013,3918,4095,7875,138,179,158.72,50.5
"2011","Barnet 039","E02000062","Total",6340,3091,3249,6302,38,60,183.85,34.5
"2011","Barnet 040","E02000063","Total",6971,3450,3521,6886,85,86,103.74,67.2
"2011","Barnet 041","E02000064","Total",6248,3014,3234,6016,232,100,79.44,78.7
"2011","Bexley 001","E02000065","Total",7666,3708,3958,7652,14,121,320.49,23.9
"2011","Bexley 002","E02000066","Total",9641,4593,5048,9599,42,123,157.29,61.3
"2011","Bexley 003","E02000067","Total",8750,4206,4544,8737,13,77,231.38,37.8
"2011","Bexley 004","E02000068","Total",7388,3598,3790,7388,0,66,227.17,32.5
"2011","Bexley 005","E02000069","Total",6194,2991,3203,6144,50,63,145.13,42.7
"2011","Bexley 006","E02000070","Total",7875,3788,4087,7875,0,93,185.59,42.4
"2011","Bexley 007","E02000071","Total",7300,3531,3769,7300,0,75,117.87,61.9
"2011","Bexley 008","E02000072","Total",11734,5620,6114,11726,8,114,437.53,26.8
"2011","Bexley 009","E02000073","Total",10724,5203,5521,10724,0,135,160.00,67.0
"2011","Bexley 010","E02000074","Total",7655,3576,4079,7573,82,50,112.90,67.8
"2011","Bexley 011","E02000075","Total",7948,3865,4083,7920,28,108,153.52,51.8
"2011","Bexley 013","E02000077","Total",7823,3748,4075,7760,63,88,111.72,70.0
"2011","Bexley 014","E02000078","Total",7665,3718,3947,7665,0,76,148.78,51.5
"2011","Bexley 015","E02000079","Total",7865,3728,4137,7713,152,91,164.79,47.7
"2011","Bexley 016","E02000080","Total",9430,4546,4884,9430,0,117,169.16,55.7
"2011","Bexley 017","E02000081","Total",7513,3653,3860,7486,27,84,220.56,34.1
"2011","Bexley 018","E02000082","Total",8876,4338,4538,8876,0,88,149.76,59.3
"2011","Bexley 019","E02000083","Total",9771,4783,4988,9750,21,87,373.92,26.1
"2011","Bexley 020","E02000084","Total",10641,5257,5384,10635,6,156,259.36,41.0
"2011","Bexley 021","E02000085","Total",7893,3765,4128,7893,0,70,162.35,48.6
"2011","Bexley 022","E02000086","Total",7328,3584,3744,7323,5,83,148.85,49.2
"2011","Bexley 023","E02000087","Total",7579,3716,3863,7559,20,108,371.61,20.4
"2011","Bexley 024","E02000088","Total",7737,3790,3947,7737,0,93,199.88,38.7
"2011","Bexley 025","E02000089","Total",7783,3737,4046,7635,148,92,136.76,56.9
"2011","Bexley 026","E02000090","Total",8726,4021,4705,8469,257,94,180.96,48.2
"2011","Bexley 027","E02000091","Total",9682,4540,5142,9542,140,115,273.35,35.4
"2011","Bexley 028","E02000092","Total",6426,3000,3426,6407,19,48,599.18,10.7
"2011","Bexley 029","E02006785","Total",6384,3073,3311,6384,0,62,136.09,46.9
"2011","Brent 001","E02000093","Total",10883,5404,5479,10776,107,109,137.73,79.0
"2011","Brent 002","E02000094","Total",8746,4388,4358,8640,106,108,116.37,75.2
"2011","Brent 003","E02000095","Total",9921,4945,4976,9783,138,121,154.87,64.1
"2011","Brent 004","E02000096","Total",7598,3745,3853,7535,63,163,163.55,46.5
"2011","Brent 005","E02000097","Total",8958,4559,4399,8958,0,118,187.13,47.9
"2011","Brent 006","E02000098","Total",7944,4040,3904,7917,27,134,183.86,43.2
"2011","Brent 007","E02000099","Total",8707,4289,4418,8651,56,95,128.73,67.6
"2011","Brent 008","E02000100","Total",8388,4092,4296,7718,670,170,207.85,40.4
"2011","Brent 009","E02000101","Total",9332,4641,4691,9162,170,121,140.38,66.5
"2011","Brent 010","E02000102","Total",7787,3812,3975,7783,4,64,135.93,57.3
"2011","Brent 011","E02000103","Total",8723,4311,4412,8705,18,94,177.20,49.2
"2011","Brent 012","E02000104","Total",6767,3431,3336,6665,102,97,110.78,61.1
"2011","Brent 013","E02000105","Total",9202,4809,4393,9160,42,94,137.00,67.2
"2011","Brent 014","E02000106","Total",10217,5126,5091,10208,9,76,134.11,76.2
"2011","Brent 015","E02000107","Total",10692,5509,5183,10625,67,64,95.47,112.0
"2011","Brent 016","E02000108","Total",6584,3389,3195,6565,19,74,81.28,81.0
"2011","Brent 017","E02000109","Total",9864,5185,4679,9693,171,83,194.09,50.8
"2011","Brent 018","E02000110","Total",8087,4114,3973,8083,4,87,79.90,101.2
"2011","Brent 019","E02000111","Total",9782,5059,4723,9696,86,114,112.78,86.7
"2011","Brent 020","E02000112","Total",9432,5017,4415,9326,106,83,126.88,74.3
"2011","Brent 021","E02000113","Total",9655,4615,5040,9655,0,79,148.37,65.1
"2011","Brent 022","E02000114","Total",9010,4519,4491,8997,13,59,61.34,146.9
"2011","Brent 023","E02000115","Total",8340,4278,4062,8298,42,85,84.87,98.3
"2011","Brent 024","E02000116","Total",8153,4087,4066,8146,7,57,109.64,74.4
"2011","Brent 025","E02000117","Total",12013,5839,6174,11944,69,114,88.99,135.0
"2011","Brent 026","E02000118","Total",9425,4923,4502,9419,6,104,123.39,76.4
"2011","Brent 027","E02000119","Total",7248,3558,3690,7222,26,90,257.13,28.2
"2011","Brent 028","E02000120","Total",9214,4541,4673,9204,10,61,50.61,182.1
"2011","Brent 029","E02000121","Total",8933,4584,4349,8932,1,60,139.54,64.0
"2011","Brent 030","E02000122","Total",8079,3901,4178,8063,16,146,120.24,67.2
"2011","Brent 031","E02000123","Total",14719,7453,7266,14657,62,110,103.49,142.2
"2011","Brent 032","E02000124","Total",10222,5088,5134,10168,54,110,109.65,93.2
"2011","Brent 033","E02000125","Total",10815,5320,5495,10803,12,114,76.58,141.2
"2011","Brent 034","E02000126","Total",7775,3897,3878,7738,37,63,43.79,177.6
"2011","Bromley 001","E02000127","Total",8483,3915,4568,8435,48,73,222.54,38.1
"2011","Bromley 002","E02000128","Total",7294,3494,3800,7230,64,99,253.69,28.8
"2011","Bromley 004","E02000130","Total",7914,3819,4095,7889,25,84,148.61,53.3
"2011","Bromley 005","E02000131","Total",8954,4413,4541,8894,60,63,176.66,50.7
"2011","Bromley 006","E02000132","Total",8567,4163,4404,8486,81,57,173.78,49.3
"2011","Bromley 007","E02000133","Total",9606,4600,5006,9403,203,285,597.69,16.1
"2011","Bromley 008","E02000134","Total",10773,5170,5603,10614,159,130,193.51,55.7
"2011","Bromley 009","E02000135","Total",9734,4688,5046,9614,120,91,115.69,84.1
"2011","Bromley 010","E02000136","Total",5728,2724,3004,5323,405,96,455.89,12.6
"2011","Bromley 011","E02000137","Total",7826,3725,4101,7679,147,136,186.13,42.0
"2011","Bromley 012","E02000138","Total",7936,3838,4098,7927,9,147,208.45,38.1
"2011","Bromley 013","E02000139","Total",7284,3468,3816,7266,18,112,153.62,47.4
"2011","Bromley 014","E02000140","Total",8041,3751,4290,8041,0,65,188.72,42.6
"2011","Bromley 015","E02000141","Total",6940,3348,3592,6918,22,84,93.32,74.4
"2011","Bromley 016","E02000142","Total",8285,3961,4324,8075,210,150,177.97,46.6
"2011","Bromley 018","E02000144","Total",8681,4238,4443,8663,18,137,198.51,43.7
"2011","Bromley 019","E02000145","Total",8086,3756,4330,8076,10,65,1128.05,7.2
"2011","Bromley 020","E02000146","Total",8324,3988,4336,8170,154,103,180.36,46.2
"2011","Bromley 021","E02000147","Total",7969,3912,4057,7951,18,237,225.04,35.4
"2011","Bromley 022","E02000148","Total",6585,3161,3424,6554,31,118,280.68,23.5
"2011","Bromley 023","E02000149","Total",7708,3687,4021,7706,2,87,187.88,41.0
"2011","Bromley 024","E02000150","Total",8351,3991,4360,8235,116,170,307.72,27.1
"2011","Bromley 025","E02000151","Total",7574,3628,3946,7574,0,140,210.17,36.0
"2011","Bromley 026","E02000152","Total",6572,3128,3444,6561,11,61,257.31,25.5
"2011","Bromley 027","E02000153","Total",7755,3750,4005,7755,0,152,224.79,34.5
"2011","Bromley 028","E02000154","Total",7959,3876,4083,7917,42,149,208.63,38.1
"2011","Bromley 029","E02000155","Total",6905,3338,3567,6905,0,75,181.73,38.0
"2011","Bromley 030","E02000156","Total",12094,5817,6277,12022,72,252,384.34,31.5
"2011","Bromley 031","E02000157","Total",7964,3826,4138,7964,0,147,244.75,32.5
"2011","Bromley 032","E02000158","Total",7364,3525,3839,7364,0,82,216.05,34.1
"2011","Bromley 033","E02000159","Total",6812,3278,3534,6812,0,165,588.62,11.6
"2011","Bromley 034","E02000160","Total",7856,3816,4040,7725,131,162,845.94,9.3
"2011","Bromley 035","E02000161","Total",8410,4066,4344,8378,32,129,171.90,48.9
"2011","Bromley 036","E02000162","Total",6693,3116,3577,6647,46,84,1276.02,5.2
"2011","Bromley 037","E02000163","Total",7650,3749,3901,7650,0,145,1130.68,6.8
"2011","Bromley 039","E02000165","Total",7045,3466,3579,7045,0,83,566.20,12.4
"2011","Bromley 040","E02006782","Total",7648,3630,4018,7565,83,114,259.96,29.4
"2011","Bromley 041","E02006787","Total",7594,3632,3962,7575,19,111,150.82,50.4
"2011","Bromley 042","E02006789","Total",6428,3137,3291,6415,13,117,2243.03,2.9
"2011","Croydon 001","E02000194","Total",8696,4249,4447,8536,160,81,139.20,62.5
"2011","Croydon 002","E02000195","Total",9152,4505,4647,9112,40,197,193.66,47.3
"2011","Croydon 003","E02000196","Total",7403,3628,3775,7366,37,122,122.62,60.4
"2011","Croydon 004","E02000197","Total",9094,4382,4712,9072,22,119,99.26,91.6
"2011","Croydon 005","E02000198","Total",8070,3870,4200,8021,49,96,89.21,90.5
"2011","Croydon 006","E02000199","Total",8430,3966,4464,8423,7,116,86.28,97.7
"2011","Croydon 007","E02000200","Total",8294,4045,4249,8192,102,108,124.74,66.5
"2011","Croydon 008","E02000201","Total",8281,3995,4286,8281,0,84,85.91,96.4
"2011","Croydon 009","E02000202","Total",8548,4216,4332,8503,45,130,73.51,116.3
"2011","Croydon 010","E02000203","Total",7539,3649,3890,7494,45,61,77.36,97.5
"2011","Croydon 011","E02000204","Total",9407,4528,4879,9310,97,117,108.66,86.6
"2011","Croydon 013","E02000206","Total",9539,4631,4908,9399,140,73,146.11,65.3
"2011","Croydon 014","E02000207","Total",8999,4319,4680,8977,22,101,124.09,72.5
"2011","Croydon 015","E02000208","Total",9790,4740,5050,9645,145,87,87.54,111.8
"2011","Croydon 016","E02000209","Total",8414,4104,4310,8411,3,88,100.29,83.9
"2011","Croydon 017","E02000210","Total",8310,3980,4330,8300,10,86,77.51,107.2
"2011","Croydon 018","E02000211","Total",8000,3851,4149,8000,0,128,167.82,47.7
"2011","Croydon 019","E02000212","Total",8523,4202,4321,8522,1,87,124.15,68.7
"2011","Croydon 020","E02000213","Total",9551,4780,4771,9495,56,73,103.09,92.6
"2011","Croydon 021","E02000214","Total",6236,3116,3120,6219,17,101,103.09,60.5
"2011","Croydon 022","E02000215","Total",10518,5425,5093,10414,104,65,98.66,106.6
"2011","Croydon 023","E02000216","Total",6738,3332,3406,6622,116,110,218.68,30.8
"2011","Croydon 024","E02000217","Total",9688,4776,4912,9688,0,71,143.11,67.7
"2011","Croydon 025","E02000218","Total",6640,3098,3542,6640,0,126,113.80,58.3
"2011","Croydon 026","E02000219","Total",7686,3649,4037,7650,36,175,570.94,13.5
"2011","Croydon 027","E02000220","Total",9881,5075,4806,9509,372,69,149.56,66.1
"2011","Croydon 028","E02000221","Total",9820,4649,5171,9630,190,96,280.56,35.0
"2011","Croydon 029","E02000222","Total",7891,3919,3972,7806,85,102,186.13,42.4
"2011","Croydon 030","E02000223","Total",8371,3725,4646,8371,0,61,96.16,87.1
"2011","Croydon 031","E02000224","Total",7684,3813,3871,7646,38,90,128.07,60.0
"2011","Croydon 032","E02000225","Total",7535,3543,3992,7534,1,64,163.12,46.2
"2011","Croydon 033","E02000226","Total",7539,3740,3799,7350,189,157,328.15,23.0
"2011","Croydon 034","E02000227","Total",11411,5380,6031,11411,0,145,459.98,24.8
"2011","Croydon 035","E02000228","Total",7609,3704,3905,7539,70,190,312.96,24.3
"2011","Croydon 036","E02000229","Total",6374,2990,3384,6315,59,40,132.00,48.3
"2011","Croydon 037","E02000230","Total",10045,4929,5116,9745,300,189,261.46,38.4
"2011","Croydon 038","E02000231","Total",7685,3795,3890,7441,244,286,336.25,22.9
"2011","Croydon 039","E02000232","Total",6207,2983,3224,6178,29,98,437.14,14.2
"2011","Croydon 040","E02000233","Total",6135,2955,3180,5977,158,73,158.66,38.7
"2011","Croydon 041","E02000234","Total",8023,3897,4126,7980,43,111,311.05,25.8
"2011","Croydon 042","E02000235","Total",6968,3354,3614,6900,68,142,539.57,12.9
"2011","Croydon 043","E02000236","Total",7659,3743,3916,7631,28,121,357.47,21.4
"2011","Croydon 044","E02000237","Total",7475,3556,3919,7455,20,107,494.95,15.1
"2011","Croydon 045","E02006788","Total",7520,3438,4082,7520,0,80,139.36,54.0
"2011","Ealing 001","E02000238","Total",9500,4865,4635,9381,119,112,152.31,62.4
"2011","Ealing 002","E02000239","Total",9000,4563,4437,9000,0,100,235.50,38.2
"2011","Ealing 003","E02000240","Total",10265,4954,5311,10265,0,99,172.80,59.4
"2011","Ealing 004","E02000241","Total",6639,3288,3351,6639,0,59,130.51,50.9
"2011","Ealing 005","E02000242","Total",6763,3527,3236,6763,0,68,88.85,76.1
"2011","Ealing 006","E02000243","Total",8509,4286,4223,8467,42,90,284.60,29.9
"2011","Ealing 007","E02000244","Total",7172,3667,3505,7172,0,88,179.67,39.9
"2011","Ealing 008","E02000245","Total",8156,3927,4229,8144,12,78,165.54,49.3
"2011","Ealing 009","E02000246","Total",8748,4293,4455,8748,0,84,205.74,42.5
"2011","Ealing 010","E02000247","Total",10308,4952,5356,10090,218,103,139.81,73.7
"2011","Ealing 011","E02000248","Total",7334,3643,3691,7334,0,71,172.68,42.5
"2011","Ealing 012","E02000249","Total",7721,3842,3879,7678,43,84,127.83,60.4
"2011","Ealing 013","E02000250","Total",6487,3093,3394,6367,120,146,99.78,65.0
"2011","Ealing 014","E02000251","Total",7944,4008,3936,7944,0,113,94.57,84.0
"2011","Ealing 015","E02000252","Total",9706,5073,4633,9647,59,76,319.64,30.4
"2011","Ealing 016","E02000253","Total",9632,4615,5017,9565,67,105,115.61,83.3
"2011","Ealing 017","E02000254","Total",8949,4542,4407,8827,122,117,104.10,86.0
"2011","Ealing 018","E02000255","Total",9465,4583,4882,9329,136,170,154.85,61.1
"2011","Ealing 019","E02000256","Total",8861,4381,4480,8651,210,181,109.64,80.8
"2011","Ealing 020","E02000257","Total",13509,6703,6806,13210,299,186,218.11,61.9
"2011","Ealing 021","E02000258","Total",6730,3413,3317,6659,71,55,103.26,65.2
"2011","Ealing 022","E02000259","Total",6276,3045,3231,6275,1,132,127.80,49.1
"2011","Ealing 023","E02000260","Total",8710,4500,4210,8532,178,82,108.64,80.2
"2011","Ealing 024","E02000261","Total",10766,5272,5494,10752,14,114,130.46,82.5
"2011","Ealing 025","E02000262","Total",8925,4456,4469,8755,170,83,70.74,126.2
"2011","Ealing 026","E02000263","Total",11637,6173,5464,11575,62,99,123.52,94.2
"2011","Ealing 027","E02000264","Total",8103,4040,4063,7979,124,147,143.67,56.4
"2011","Ealing 028","E02000265","Total",11119,5542,5577,10981,138,107,101.36,109.7
"2011","Ealing 029","E02000266","Total",12331,6141,6190,11638,693,111,386.75,31.9
"2011","Ealing 030","E02000267","Total",6926,3403,3523,6913,13,65,75.35,91.9
"2011","Ealing 031","E02000268","Total",9358,4666,4692,9125,233,133,132.59,70.6
"2011","Ealing 032","E02000269","Total",8078,3947,4131,8003,75,129,88.50,91.3
"2011","Ealing 033","E02000270","Total",8043,3883,4160,8040,3,82,79.62,101.0
"2011","Ealing 034","E02000271","Total",6763,3331,3432,6757,6,115,74.75,90.5
"2011","Ealing 035","E02000272","Total",6748,3318,3430,6703,45,118,119.88,56.3
"2011","Ealing 037","E02000274","Total",12733,6846,5887,12724,9,110,143.53,88.7
"2011","Ealing 038","E02000275","Total",7102,3631,3471,6923,179,103,117.26,60.6
"2011","Ealing 039","E02000276","Total",6722,3449,3273,6459,263,70,84.14,79.9
"2011","Ealing 040","E02006791","Total",6711,3314,3397,6711,0,52,68.54,97.9
"2011","Enfield 001","E02000277","Total",7081,3391,3690,7038,43,90,104.70,67.6
"2011","Enfield 002","E02000278","Total",8837,4175,4662,8771,66,97,131.48,67.2
"2011","Enfield 003","E02000279","Total",11292,5328,5964,11289,3,101,260.82,43.3
"2011","Enfield 004","E02000280","Total",8515,4023,4492,8464,51,94,1556.46,5.5
"2011","Enfield 005","E02000281","Total",8835,4200,4635,8705,130,78,189.78,46.6
"2011","Enfield 006","E02000282","Total",9115,4245,4870,9112,3,88,126.23,72.2
"2011","Enfield 007","E02000283","Total",8424,4022,4402,8408,16,72,114.06,73.9
"2011","Enfield 008","E02000284","Total",8200,3980,4220,8152,48,135,128.31,63.9
"2011","Enfield 009","E02000285","Total",6597,3204,3393,6568,29,118,98.52,67.0
"2011","Enfield 010","E02000286","Total",8158,4011,4147,7940,218,120,205.07,39.8
"2011","Enfield 011","E02000287","Total",6823,3293,3530,6494,329,178,886.75,7.7
"2011","Enfield 012","E02000288","Total",10490,5090,5400,10462,28,103,211.62,49.6
"2011","Enfield 013","E02000289","Total",6569,3145,3424,6569,0,127,340.12,19.3
"2011","Enfield 014","E02000290","Total",7242,3472,3770,7242,0,64,488.35,14.8
"2011","Enfield 015","E02000291","Total",8924,4374,4550,8809,115,93,115.73,77.1
"2011","Enfield 016","E02000292","Total",9518,4577,4941,9495,23,96,187.90,50.7
"2011","Enfield 017","E02000293","Total",6307,3146,3161,6274,33,125,215.89,29.2
"2011","Enfield 018","E02000294","Total",8879,4240,4639,8700,179,111,150.05,59.2
"2011","Enfield 019","E02000295","Total",8374,4008,4366,8287,87,103,162.01,51.7
"2011","Enfield 020","E02000296","Total",9535,4511,5024,9406,129,88,180.19,52.9
"2011","Enfield 021","E02000297","Total",9298,4532,4766,9235,63,176,162.03,57.4
"2011","Enfield 022","E02000298","Total",7976,3978,3998,7909,67,126,200.01,39.9
"2011","Enfield 023","E02000299","Total",9312,4494,4818,9262,50,96,87.70,106.2
"2011","Enfield 024","E02000300","Total",8157,3933,4224,8102,55,87,77.70,105.0
"2011","Enfield 025","E02000301","Total",10070,4787,5283,10070,0,83,182.30,55.2
"2011","Enfield 026","E02000302","Total",8326,4031,4295,8276,50,92,158.03,52.7
"2011","Enfield 027","E02000303","Total",8390,3967,4423,8372,18,88,124.23,67.5
"2011","Enfield 028","E02000304","Total",8089,3936,4153,7997,92,189,172.07,47.0
"2011","Enfield 029","E02000305","Total",8633,4310,4323,8473,160,157,96.10,89.8
"2011","Enfield 030","E02000306","Total",9149,4287,4862,9149,0,87,208.73,43.8
"2011","Enfield 031","E02000307","Total",9873,4774,5099,9873,0,126,110.59,89.3
"2011","Enfield 032","E02000308","Total",7736,3881,3855,7661,75,68,114.73,67.4
"2011","Enfield 033","E02000309","Total",10489,5126,5363,10412,77,96,162.85,64.4
"2011","Enfield 035","E02000311","Total",9872,4777,5095,9861,11,100,141.70,69.7
"2011","Enfield 036","E02000312","Total",10473,5259,5214,10404,69,93,131.02,79.9
"2011","Enfield 037","E02006793","Total",8908,4147,4761,8825,83,90,99.11,89.9
"2011","Greenwich 001","E02000313","Total",6566,3290,3276,6563,3,59,73.06,89.9
"2011","Greenwich 002","E02000314","Total",13164,6745,6419,12265,899,146,318.85,41.3
"2011","Greenwich 003","E02000315","Total",9080,4331,4749,9039,41,90,119.29,76.1
"2011","Greenwich 004","E02000316","Total",10750,5559,5191,10698,52,65,188.44,57.0
"2011","Greenwich 005","E02000317","Total",8370,4134,4236,8293,77,86,65.28,128.2
"2011","Greenwich 006","E02000318","Total",9842,5058,4784,9842,0,91,110.48,89.1
"2011","Greenwich 007","E02000319","Total",10971,5668,5303,10825,146,94,92.56,118.5
"2011","Greenwich 008","E02000320","Total",6624,3207,3417,6603,21,53,146.00,45.4
"2011","Greenwich 009","E02000321","Total",7200,3535,3665,7147,53,79,62.24,115.7
"2011","Greenwich 011","E02000323","Total",10674,5454,5220,10631,43,107,76.15,140.2
"2011","Greenwich 012","E02000324","Total",7315,3523,3792,7181,134,67,130.36,56.1
"2011","Greenwich 014","E02000326","Total",7070,3409,3661,7063,7,92,73.04,96.8
"2011","Greenwich 015","E02000327","Total",6825,3539,3286,6436,389,82,185.88,36.7
"2011","Greenwich 016","E02000328","Total",6606,3232,3374,6512,94,102,87.60,75.4
"2011","Greenwich 017","E02000329","Total",6180,3102,3078,6169,11,47,176.21,35.1
"2011","Greenwich 019","E02000331","Total",7831,3805,4026,7805,26,42,99.23,78.9
"2011","Greenwich 020","E02000332","Total",7253,3604,3649,7239,14,99,201.77,35.9
"2011","Greenwich 021","E02000333","Total",6269,3087,3182,6152,117,98,126.13,49.7
"2011","Greenwich 022","E02000334","Total",6469,3179,3290,6463,6,90,138.56,46.7
"2011","Greenwich 023","E02000335","Total",6549,3229,3320,6549,0,80,129.42,50.6
"2011","Greenwich 025","E02000337","Total",7906,3821,4085,7906,0,78,139.82,56.5
"2011","Greenwich 027","E02000339","Total",5970,2926,3044,5963,7,88,125.65,47.5
"2011","Greenwich 028","E02000340","Total",6088,2977,3111,6086,2,54,326.54,18.6
"2011","Greenwich 029","E02000341","Total",7683,3656,4027,7683,0,63,179.17,42.9
"2011","Greenwich 030","E02000342","Total",6453,3020,3433,5379,1074,48,136.11,47.4
"2011","Greenwich 031","E02000343","Total",6675,3272,3403,6658,17,57,125.65,53.1
"2011","Greenwich 032","E02000344","Total",6387,3150,3237,6277,110,54,129.21,49.4
"2011","Greenwich 033","E02006786","Total",6894,3445,3449,6894,0,72,124.41,55.4
"2011","Greenwich 034","E02006927","Total",8315,4065,4250,8241,74,121,252.11,33.0
"2011","Greenwich 035","E02006928","Total",7341,3632,3709,6410,931,70,53.99,136.0
"2011","Greenwich 036","E02006929","Total",7490,3698,3792,7489,1,44,255.02,29.4
"2011","Greenwich 037","E02006930","Total",6561,3315,3246,6557,4,45,86.77,75.6
"2011","Greenwich 038","E02006931","Total",9186,4557,4629,8973,213,79,199.38,46.1
"2011","Harrow 001","E02000433","Total",7686,3530,4156,7558,128,171,631.78,12.2
"2011","Harrow 002","E02000434","Total",8588,4170,4418,8525,63,229,196.27,43.8
"2011","Harrow 003","E02000435","Total",7426,3594,3832,7322,104,146,180.68,41.1
"2011","Harrow 004","E02000436","Total",5782,2812,2970,5721,61,205,472.20,12.2
"2011","Harrow 005","E02000437","Total",8377,4025,4352,8298,79,172,139.65,60.0
"2011","Harrow 006","E02000438","Total",7910,3733,4177,7821,89,137,175.14,45.2
"2011","Harrow 007","E02000439","Total",8206,4077,4129,8206,0,108,106.35,77.2
"2011","Harrow 008","E02000440","Total",9569,4744,4825,9518,51,176,149.53,64.0
"2011","Harrow 009","E02000441","Total",6714,3193,3521,6680,34,132,233.59,28.7
"2011","Harrow 010","E02000442","Total",8706,4380,4326,8706,0,101,113.96,76.4
"2011","Harrow 011","E02000443","Total",9470,4650,4820,9431,39,126,97.80,96.8
"2011","Harrow 012","E02000444","Total",8499,4184,4315,8418,81,133,109.43,77.7
"2011","Harrow 013","E02000445","Total",10250,5189,5061,10211,39,131,125.09,81.9
"2011","Harrow 015","E02000447","Total",7058,3456,3602,7052,6,186,212.39,33.2
"2011","Harrow 016","E02000448","Total",6641,3171,3470,6606,35,174,172.03,38.6
"2011","Harrow 017","E02000449","Total",8137,4072,4065,8131,6,109,91.82,88.6
"2011","Harrow 019","E02000451","Total",6550,3213,3337,6531,19,134,159.92,41.0
"2011","Harrow 020","E02000452","Total",8218,4262,3956,8125,93,83,112.45,73.1
"2011","Harrow 021","E02000453","Total",7620,3782,3838,7606,14,122,103.40,73.7
"2011","Harrow 022","E02000454","Total",7082,3456,3626,7079,3,204,156.69,45.2
"2011","Harrow 023","E02000455","Total",8135,4068,4067,8050,85,83,123.16,66.1
"2011","Harrow 024","E02000456","Total",7059,3483,3576,7028,31,103,92.55,76.3
"2011","Harrow 025","E02000457","Total",6314,3146,3168,6309,5,136,116.00,54.4
"2011","Harrow 027","E02000459","Total",8235,4079,4156,8227,8,97,119.96,68.6
"2011","Harrow 028","E02000460","Total",6518,3200,3318,6488,30,89,86.61,75.3
"2011","Harrow 029","E02000461","Total",6947,3824,3123,6066,881,155,266.20,26.1
"2011","Harrow 030","E02000462","Total",6632,3320,3312,6624,8,93,99.94,66.4
"2011","Harrow 031","E02000463","Total",8429,4161,4268,8422,7,111,92.90,90.7
"2011","Harrow 032","E02006795","Total",8124,4040,4084,8108,16,126,96.61,84.1
"2011","Harrow 033","E02006882","Total",14174,7009,7165,14103,71,279,212.81,66.6
"2011","Havering 001","E02000464","Total",6451,3071,3380,6338,113,42,585.71,11.0
"2011","Havering 002","E02000465","Total",7930,3838,4092,7929,1,40,280.05,28.3
"2011","Havering 003","E02000466","Total",8287,3905,4382,8188,99,54,627.94,13.2
"2011","Havering 004","E02000467","Total",9643,4600,5043,9604,39,90,135.87,71.0
"2011","Havering 005","E02000468","Total",7782,3691,4091,7705,77,32,409.37,19.0
"2011","Havering 006","E02000469","Total",6443,3036,3407,6332,111,26,171.41,37.6
"2011","Havering 007","E02000470","Total",7887,3842,4045,7854,33,74,676.26,11.7
"2011","Havering 008","E02000471","Total",7457,3581,3876,7449,8,114,214.07,34.8
"2011","Havering 009","E02000472","Total",8989,4345,4644,8954,35,81,153.57,58.5
"2011","Havering 010","E02000473","Total",9588,4608,4980,9555,33,115,285.56,33.6
"2011","Havering 011","E02000474","Total",8343,3961,4382,8297,46,49,220.73,37.8
"2011","Havering 012","E02000475","Total",9196,4414,4782,9107,89,126,280.27,32.8
"2011","Havering 013","E02000476","Total",8414,4130,4284,8330,84,68,156.66,53.7
"2011","Havering 014","E02000477","Total",9360,4550,4810,9347,13,110,174.95,53.5
"2011","Havering 015","E02000478","Total",5885,2901,2984,5811,74,102,249.12,23.6
"2011","Havering 016","E02000479","Total",8134,3871,4263,8022,112,77,137.50,59.2
"2011","Havering 017","E02000480","Total",9795,4765,5030,9676,119,98,337.55,29.0
"2011","Havering 018","E02000481","Total",7793,3637,4156,7672,121,74,1224.59,6.4
"2011","Havering 019","E02000482","Total",6396,3127,3269,6374,22,107,282.60,22.6
"2011","Havering 020","E02000483","Total",7614,3606,4008,7562,52,94,160.27,47.5
"2011","Havering 021","E02000484","Total",8199,4041,4158,8187,12,90,185.06,44.3
"2011","Havering 022","E02000485","Total",7986,3792,4194,7956,30,91,209.52,38.1
"2011","Havering 023","E02000486","Total",7366,3580,3786,7300,66,66,127.44,57.8
"2011","Havering 024","E02000487","Total",7843,3771,4072,7748,95,150,1288.05,6.1
"2011","Havering 025","E02000488","Total",7431,3601,3830,7431,0,81,182.86,40.6
"2011","Havering 026","E02000489","Total",7884,3792,4092,7884,0,80,259.92,30.3
"2011","Havering 027","E02000490","Total",7828,3728,4100,7828,0,64,205.15,38.2
"2011","Havering 028","E02000491","Total",8826,4406,4420,8774,52,77,480.09,18.4
"2011","Havering 029","E02000492","Total",6272,3076,3196,6247,25,56,1405.30,4.5
"2011","Havering 030","E02000493","Total",6210,2943,3267,6210,0,55,128.91,48.2
"2011","Hillingdon 001","E02000494","Total",7479,3559,3920,7388,91,208,622.09,12.0
"2011","Hillingdon 002","E02000495","Total",9473,4514,4959,9348,125,140,272.80,34.7
"2011","Hillingdon 003","E02000496","Total",7399,3565,3834,7181,218,67,1522.44,4.9
"2011","Hillingdon 004","E02000497","Total",8529,4082,4447,8468,61,152,270.20,31.6
"2011","Hillingdon 005","E02000498","Total",6020,2919,3101,6020,0,80,313.78,19.2
"2011","Hillingdon 006","E02000499","Total",7765,3774,3991,7765,0,143,160.85,48.3
"2011","Hillingdon 007","E02000500","Total",7714,3829,3885,7664,50,179,289.77,26.6
"2011","Hillingdon 008","E02000501","Total",8247,3944,4303,8197,50,122,143.66,57.4
"2011","Hillingdon 009","E02000502","Total",7613,3650,3963,7512,101,82,416.55,18.3
"2011","Hillingdon 010","E02000503","Total",8986,4558,4428,8560,426,106,138.01,65.1
"2011","Hillingdon 011","E02000504","Total",7382,3601,3781,7359,23,157,306.41,24.1
"2011","Hillingdon 013","E02000506","Total",7541,3692,3849,7455,86,158,548.54,13.7
"2011","Hillingdon 014","E02000507","Total",7943,3942,4001,7943,0,114,268.81,29.5
"2011","Hillingdon 015","E02000508","Total",9184,4882,4302,7014,2170,174,274.66,33.4
"2011","Hillingdon 016","E02000509","Total",9823,4926,4897,7651,2172,128,201.39,48.8
"2011","Hillingdon 017","E02000510","Total",8634,4267,4367,8554,80,106,213.09,40.5
"2011","Hillingdon 018","E02000511","Total",9426,4717,4709,9357,69,97,238.84,39.5
"2011","Hillingdon 019","E02000512","Total",8001,4004,3997,7989,12,76,140.74,56.8
"2011","Hillingdon 020","E02000513","Total",8980,4347,4633,8967,13,57,147.13,61.0
"2011","Hillingdon 021","E02000514","Total",9820,5031,4789,9791,29,88,119.94,81.9
"2011","Hillingdon 022","E02000515","Total",10439,5271,5168,10388,51,71,315.25,33.1
"2011","Hillingdon 023","E02000516","Total",8269,4123,4146,8263,6,68,165.48,50.0
"2011","Hillingdon 024","E02000517","Total",8626,4194,4432,8570,56,96,154.71,55.8
"2011","Hillingdon 025","E02000518","Total",8606,4225,4381,8593,13,69,252.31,34.1
"2011","Hillingdon 026","E02000519","Total",8658,4376,4282,8645,13,72,181.67,47.7
"2011","Hillingdon 027","E02000520","Total",11251,5717,5534,11068,183,92,436.06,25.8
"2011","Hillingdon 028","E02000521","Total",9912,4874,5038,9904,8,95,245.39,40.4
"2011","Hillingdon 029","E02000522","Total",8653,4235,4418,8581,72,71,156.94,55.1
"2011","Hillingdon 030","E02000523","Total",9636,4866,4770,9535,101,83,164.60,58.5
"2011","Hillingdon 031","E02000524","Total",6663,3596,3067,6271,392,63,2050.90,3.2
"2011","Hillingdon 032","E02000525","Total",8826,4449,4377,8822,4,74,406.76,21.7
"2011","Hillingdon 033","E02006796","Total",8438,4082,4356,8404,34,83,430.10,19.6
"2011","Hounslow 001","E02000526","Total",8378,4029,4349,8292,86,164,92.42,90.7
"2011","Hounslow 003","E02000528","Total",10614,5187,5427,10603,11,99,232.29,45.7
"2011","Hounslow 004","E02000529","Total",8448,4299,4149,8448,0,111,118.17,71.5
"2011","Hounslow 005","E02000530","Total",6837,3358,3479,6836,1,75,272.31,25.1
"2011","Hounslow 006","E02000531","Total",10337,5062,5275,9472,865,136,255.67,40.4
"2011","Hounslow 007","E02000532","Total",9160,4523,4637,9149,11,213,228.84,40.0
"2011","Hounslow 008","E02000533","Total",8406,4216,4190,8406,0,146,106.36,79.0
"2011","Hounslow 009","E02000534","Total",8044,4112,3932,8029,15,139,486.66,16.5
"2011","Hounslow 010","E02000535","Total",9291,4779,4512,9287,4,137,154.96,60.0
"2011","Hounslow 011","E02000536","Total",9269,4726,4543,9189,80,132,160.65,57.7
"2011","Hounslow 012","E02000537","Total",8620,4542,4078,8612,8,108,188.80,45.7
"2011","Hounslow 013","E02000538","Total",8680,4496,4184,8680,0,105,235.56,36.8
"2011","Hounslow 014","E02000539","Total",10752,5191,5561,10662,90,90,164.62,65.3
"2011","Hounslow 015","E02000540","Total",9246,4807,4439,9211,35,93,125.38,73.7
"2011","Hounslow 016","E02000541","Total",8875,4511,4364,8866,9,102,105.45,84.2
"2011","Hounslow 017","E02000542","Total",9396,4825,4571,9298,98,92,104.58,89.8
"2011","Hounslow 018","E02000543","Total",11713,6109,5604,11652,61,89,114.45,102.3
"2011","Hounslow 019","E02000544","Total",8199,4093,4106,8199,0,123,138.57,59.2
"2011","Hounslow 020","E02000545","Total",8181,3947,4234,8137,44,78,131.50,62.2
"2011","Hounslow 021","E02000546","Total",9750,5004,4746,9568,182,84,245.98,39.6
"2011","Hounslow 022","E02000547","Total",9360,4648,4712,9360,0,60,326.45,28.7
"2011","Hounslow 023","E02000548","Total",9103,4468,4635,9085,18,65,352.85,25.8
"2011","Hounslow 024","E02000549","Total",11017,5484,5533,10865,152,98,245.53,44.9
"2011","Hounslow 025","E02000550","Total",10403,5117,5286,10403,0,68,94.48,110.1
"2011","Hounslow 026","E02000551","Total",8614,4246,4368,8614,0,63,212.84,40.5
"2011","Hounslow 027","E02000552","Total",8266,4222,4044,8098,168,58,306.01,27.0
"2011","Hounslow 028","E02000553","Total",6605,3230,3375,6605,0,56,252.36,26.2
"2011","Hounslow 029","E02006792","Total",8393,4166,4227,8335,58,113,144.88,57.9
"2011","Kingston upon Thames 001","E02000598","Total",7837,3752,4085,7837,0,175,133.03,58.9
"2011","Kingston upon Thames 002","E02000599","Total",7270,3480,3790,6688,582,283,415.54,17.5
"2011","Kingston upon Thames 003","E02000600","Total",8225,3960,4265,8084,141,150,110.52,74.4
"2011","Kingston upon Thames 004","E02000601","Total",10409,5156,5253,10277,132,172,107.12,97.2
"2011","Kingston upon Thames 005","E02000602","Total",9390,4602,4788,9213,177,99,107.75,87.1
"2011","Kingston upon Thames 006","E02000603","Total",7860,3750,4110,7809,51,128,132.34,59.4
"2011","Kingston upon Thames 007","E02000604","Total",8586,4168,4418,8558,28,165,153.31,56.0
"2011","Kingston upon Thames 008","E02000605","Total",7863,3784,4079,7782,81,163,143.81,54.7
"2011","Kingston upon Thames 009","E02000606","Total",10107,5132,4975,9827,280,140,149.82,67.5
"2011","Kingston upon Thames 010","E02000607","Total",6829,3331,3498,6117,712,100,144.02,47.4
"2011","Kingston upon Thames 011","E02000608","Total",6993,3483,3510,6104,889,61,82.12,85.2
"2011","Kingston upon Thames 012","E02000609","Total",7437,3598,3839,7380,57,155,147.43,50.4
"2011","Kingston upon Thames 013","E02000610","Total",7629,3789,3840,7441,188,75,111.29,68.6
"2011","Kingston upon Thames 014","E02000611","Total",7313,3662,3651,7313,0,154,179.91,40.6
"2011","Kingston upon Thames 015","E02000612","Total",8028,3909,4119,7936,92,131,188.71,42.5
"2011","Kingston upon Thames 016","E02000613","Total",7841,3733,4108,7660,181,107,120.29,65.2
"2011","Kingston upon Thames 017","E02000614","Total",8404,4117,4287,8359,45,116,295.25,28.5
"2011","Kingston upon Thames 018","E02000615","Total",7471,3642,3829,7471,0,98,163.64,45.7
"2011","Kingston upon Thames 019","E02000616","Total",6031,2973,3058,6013,18,76,131.20,46.0
"2011","Kingston upon Thames 020","E02000617","Total",8537,4082,4455,8489,48,91,707.59,12.1
"2011","Merton 001","E02000689","Total",8258,4035,4223,8239,19,158,194.91,42.4
"2011","Merton 002","E02000690","Total",5656,2780,2876,5527,129,269,540.17,10.5
"2011","Merton 003","E02000691","Total",7334,3663,3671,7168,166,163,92.84,79.0
"2011","Merton 004","E02000692","Total",7662,3720,3942,7567,95,193,114.41,67.0
"2011","Merton 005","E02000693","Total",9173,4710,4463,8935,238,71,104.74,87.6
"2011","Merton 006","E02000694","Total",8730,4273,4457,8714,16,51,77.39,112.8
"2011","Merton 007","E02000695","Total",8287,4337,3950,8269,18,87,80.65,102.8
"2011","Merton 008","E02000696","Total",8072,4059,4013,8072,0,70,74.09,108.9
"2011","Merton 009","E02000697","Total",8217,4127,4090,8134,83,70,115.84,70.9
"2011","Merton 010","E02000698","Total",7816,3764,4052,7699,117,251,175.49,44.5
"2011","Merton 011","E02000699","Total",7689,3757,3932,7666,23,109,93.05,82.6
"2011","Merton 012","E02000700","Total",8290,4006,4284,8290,0,60,92.19,89.9
"2011","Merton 013","E02000701","Total",8416,4147,4269,8410,6,69,95.66,88.0
"2011","Merton 014","E02000702","Total",7638,3705,3933,7626,12,69,155.83,49.0
"2011","Merton 015","E02000703","Total",7825,3926,3899,7825,0,172,147.49,53.1
"2011","Merton 016","E02000704","Total",7742,3799,3943,7633,109,83,167.14,46.3
"2011","Merton 017","E02000705","Total",8124,3954,4170,8083,41,126,124.16,65.4
"2011","Merton 018","E02000706","Total",8605,4126,4479,8605,0,90,90.44,95.1
"2011","Merton 019","E02000707","Total",7486,3597,3889,7482,4,114,115.97,64.6
"2011","Merton 020","E02000708","Total",8286,4085,4201,8262,24,140,164.60,50.3
"2011","Merton 021","E02000709","Total",7701,3798,3903,7681,20,134,171.70,44.9
"2011","Merton 022","E02000710","Total",8329,4073,4256,8062,267,78,322.59,25.8
"2011","Merton 023","E02000711","Total",8158,4073,4085,8133,25,75,133.08,61.3
"2011","Merton 024","E02000712","Total",8709,4280,4429,8681,28,86,163.04,53.4
"2011","Merton 025","E02000713","Total",7490,3721,3769,7454,36,78,153.40,48.8
"2011","Redbridge 001","E02000751","Total",10422,5065,5357,10265,157,262,307.48,33.9
"2011","Redbridge 002","E02000752","Total",6815,3215,3600,6815,0,52,488.42,14.0
"2011","Redbridge 003","E02000753","Total",6138,2897,3241,6088,50,36,75.76,81.0
"2011","Redbridge 004","E02000754","Total",6440,3159,3281,6440,0,85,123.29,52.2
"2011","Redbridge 005","E02000755","Total",5218,2538,2680,5211,7,62,134.61,38.8
"2011","Redbridge 006","E02000756","Total",12630,6169,6461,12625,5,172,359.36,35.1
"2011","Redbridge 007","E02000757","Total",11516,5687,5829,11474,42,181,149.15,77.2
"2011","Redbridge 008","E02000758","Total",5953,2905,3048,5953,0,109,114.65,51.9
"2011","Redbridge 009","E02000759","Total",12044,5894,6150,12020,24,151,234.40,51.4
"2011","Redbridge 010","E02000760","Total",6957,3320,3637,6915,42,74,103.90,67.0
"2011","Redbridge 012","E02000762","Total",6290,3179,3111,6273,17,156,79.95,78.7
"2011","Redbridge 013","E02000763","Total",6928,3339,3589,6910,18,104,773.53,9.0
"2011","Redbridge 014","E02000764","Total",11865,5586,6279,11690,175,140,198.57,59.8
"2011","Redbridge 015","E02000765","Total",6319,3124,3195,6313,6,106,72.71,86.9
"2011","Redbridge 017","E02000767","Total",7616,3745,3871,7475,141,111,87.70,86.8
"2011","Redbridge 018","E02000768","Total",5660,2738,2922,5660,0,113,169.88,33.3
"2011","Redbridge 019","E02000769","Total",14257,6868,7389,14146,111,158,151.43,94.1
"2011","Redbridge 020","E02000770","Total",7562,3760,3802,7542,20,108,116.49,64.9
"2011","Redbridge 022","E02000772","Total",7946,4033,3913,7783,163,103,140.31,56.6
"2011","Redbridge 023","E02000773","Total",9198,4590,4608,9193,5,121,95.20,96.6
"2011","Redbridge 024","E02000774","Total",7218,3735,3483,7180,38,94,67.91,106.3
"2011","Redbridge 026","E02000776","Total",6372,3151,3221,6338,34,102,60.04,106.1
"2011","Redbridge 027","E02000777","Total",5883,2822,3061,5852,31,127,349.90,16.8
"2011","Redbridge 029","E02000779","Total",7751,4088,3663,7658,93,32,90.21,85.9
"2011","Redbridge 030","E02000780","Total",14666,7523,7143,14643,23,131,127.12,115.4
"2011","Redbridge 031","E02000781","Total",13672,6844,6828,13646,26,150,188.38,72.6
"2011","Redbridge 032","E02000782","Total",9289,4700,4589,9141,148,69,69.78,133.1
"2011","Redbridge 033","E02000783","Total",7255,3630,3625,7196,59,52,56.65,128.1
"2011","Redbridge 034","E02006800","Total",13069,6636,6433,13014,55,161,164.60,79.4
"2011","Redbridge 035","E02006924","Total",12780,6574,6206,12623,157,189,240.61,53.1
"2011","Redbridge 036","E02006925","Total",13241,6559,6682,13241,0,282,249.15,53.1
"2011","Richmond upon Thames 001","E02000784","Total",10299,4980,5319,10248,51,298,264.59,38.9
"2011","Richmond upon Thames 002","E02000785","Total",9695,4724,4971,9585,110,238,406.04,23.9
"2011","Richmond upon Thames 003","E02000786","Total",10919,5215,5704,10865,54,203,184.50,59.2
"2011","Richmond upon Thames 004","E02000787","Total",10768,5225,5543,10768,0,136,176.09,61.2
"2011","Richmond upon Thames 005","E02000788","Total",8692,4206,4486,8676,16,201,108.47,80.1
"2011","Richmond upon Thames 006","E02000789","Total",6196,3005,3191,6106,90,108,183.55,33.8
"2011","Richmond upon Thames 007","E02000790","Total",6193,3110,3083,6193,0,129,79.79,77.6
"2011","Richmond upon Thames 008","E02000791","Total",6137,3071,3066,5846,291,135,111.69,54.9
"2011","Richmond upon Thames 009","E02000792","Total",6989,3444,3545,6832,157,139,124.53,56.1
"2011","Richmond upon Thames 010","E02000793","Total",8122,4003,4119,7990,132,123,132.67,61.2
"2011","Richmond upon Thames 011","E02000794","Total",6609,3278,3331,6577,32,101,146.48,45.1
"2011","Richmond upon Thames 012","E02000795","Total",6898,3462,3436,6544,354,215,1208.19,5.7
"2011","Richmond upon Thames 013","E02000796","Total",10313,5079,5234,10284,29,139,191.22,53.9
"2011","Richmond upon Thames 014","E02000797","Total",6979,3483,3496,6894,85,93,91.31,76.4
"2011","Richmond upon Thames 015","E02000798","Total",10528,5115,5413,10479,49,138,245.57,42.9
"2011","Richmond upon Thames 016","E02000799","Total",6415,3105,3310,5657,758,164,128.34,50.0
"2011","Richmond upon Thames 017","E02000800","Total",5184,2509,2675,5184,0,64,183.07,28.3
"2011","Richmond upon Thames 018","E02000801","Total",6608,3170,3438,6599,9,117,98.82,66.9
"2011","Richmond upon Thames 019","E02000802","Total",6747,3255,3492,6615,132,161,144.96,46.5
"2011","Richmond upon Thames 020","E02000803","Total",9387,4503,4884,9346,41,173,194.96,48.1
"2011","Richmond upon Thames 021","E02000804","Total",7106,3439,3667,7013,93,121,374.86,19.0
"2011","Richmond upon Thames 022","E02000805","Total",10221,4974,5247,9929,292,226,274.13,37.3
"2011","Richmond upon Thames 023","E02000806","Total",9985,4794,5191,9868,117,239,687.69,14.5
"2011","Sutton 001","E02000840","Total",8171,3873,4298,8146,25,45,136.75,59.8
"2011","Sutton 002","E02000841","Total",8721,4203,4518,8624,97,51,115.49,75.5
"2011","Sutton 003","E02000842","Total",7666,3763,3903,7666,0,108,161.83,47.4
"2011","Sutton 004","E02000843","Total",7495,3662,3833,7495,0,56,127.83,58.6
"2011","Sutton 005","E02000844","Total",7779,3758,4021,7779,0,62,101.10,76.9
"2011","Sutton 006","E02000845","Total",8867,4336,4531,8850,17,105,150.64,58.9
"2011","Sutton 007","E02000846","Total",7053,3423,3630,6956,97,77,136.62,51.6
"2011","Sutton 008","E02000847","Total",8798,4331,4467,8708,90,104,154.12,57.1
"2011","Sutton 009","E02000848","Total",7889,3884,4005,7889,0,127,114.92,68.6
"2011","Sutton 010","E02000849","Total",7485,3589,3896,7432,53,97,119.41,62.7
"2011","Sutton 011","E02000850","Total",10309,5101,5208,10301,8,161,497.98,20.7
"2011","Sutton 012","E02000851","Total",8330,4107,4223,8297,33,61,114.16,73.0
"2011","Sutton 013","E02000852","Total",7434,3631,3803,7424,10,94,94.78,78.4
"2011","Sutton 014","E02000853","Total",7592,3696,3896,7592,0,93,124.64,60.9
"2011","Sutton 015","E02000854","Total",7101,3484,3617,7067,34,117,162.70,43.6
"2011","Sutton 016","E02000855","Total",7787,3797,3990,7767,20,176,186.21,41.8
"2011","Sutton 017","E02000856","Total",8176,4021,4155,8137,39,120,125.27,65.3
"2011","Sutton 018","E02000857","Total",7905,3800,4105,7646,259,71,102.03,77.5
"2011","Sutton 019","E02000858","Total",7691,3603,4088,7686,5,57,153.27,50.2
"2011","Sutton 020","E02000859","Total",8165,3839,4326,7986,179,151,171.07,47.7
"2011","Sutton 021","E02000860","Total",7598,3737,3861,7423,175,45,87.85,86.5
"2011","Sutton 022","E02000861","Total",7497,3687,3810,7479,18,251,256.22,29.3
"2011","Sutton 024","E02000863","Total",6367,3115,3252,6283,84,140,656.44,9.7
"2011","Sutton 025","E02006836","Total",8270,4003,4267,8062,208,218,333.69,24.8
"2011","Waltham Forest 001","E02000895","Total",7979,3804,4175,7962,17,76,219.25,36.4
"2011","Waltham Forest 002","E02000896","Total",8814,4261,4553,8719,95,99,281.39,31.3
"2011","Waltham Forest 003","E02000897","Total",8077,3812,4265,7991,86,106,188.28,42.9
"2011","Waltham Forest 004","E02000898","Total",7750,3750,4000,7677,73,112,153.15,50.6
"2011","Waltham Forest 005","E02000899","Total",7920,3809,4111,7866,54,83,120.34,65.8
"2011","Waltham Forest 006","E02000900","Total",8088,3894,4194,8062,26,72,155.32,52.1
"2011","Waltham Forest 007","E02000901","Total",9371,4499,4872,9302,69,155,171.86,54.5
"2011","Waltham Forest 008","E02000902","Total",8231,4053,4178,8229,2,98,121.60,67.7
"2011","Waltham Forest 009","E02000903","Total",9043,4423,4620,9043,0,94,196.64,46.0
"2011","Waltham Forest 010","E02000904","Total",8228,4105,4123,8213,15,68,145.91,56.4
"2011","Waltham Forest 011","E02000905","Total",9589,4806,4783,9512,77,82,104.94,91.4
"2011","Waltham Forest 012","E02000906","Total",9248,4564,4684,9246,2,58,61.81,149.6
"2011","Waltham Forest 013","E02000907","Total",9998,4873,5125,9634,364,81,89.36,111.9
"2011","Waltham Forest 014","E02000908","Total",10516,5557,4959,10516,0,59,235.55,44.6
"2011","Waltham Forest 015","E02000909","Total",8640,4188,4452,8635,5,84,139.24,62.1
"2011","Waltham Forest 016","E02000910","Total",10698,5438,5260,10647,51,61,79.07,135.3
"2011","Waltham Forest 017","E02000911","Total",10872,5527,5345,10868,4,44,89.06,122.1
"2011","Waltham Forest 018","E02000912","Total",9238,4582,4656,9143,95,71,249.98,37.0
"2011","Waltham Forest 019","E02000913","Total",8706,4466,4240,8660,46,64,105.70,82.4
"2011","Waltham Forest 020","E02000914","Total",10594,5336,5258,10499,95,58,69.97,151.4
"2011","Waltham Forest 021","E02000915","Total",8643,4530,4113,8399,244,94,149.33,57.9
"2011","Waltham Forest 022","E02000916","Total",9485,4747,4738,9482,3,39,222.25,42.7
"2011","Waltham Forest 023","E02000917","Total",9171,4588,4583,9148,23,48,67.88,135.1
"2011","Waltham Forest 024","E02000918","Total",9126,4727,4399,9041,85,83,83.29,109.6
"2011","Waltham Forest 025","E02000919","Total",9221,4696,4525,9200,21,44,56.24,164.0
"2011","Waltham Forest 026","E02000920","Total",9479,4786,4693,9471,8,49,174.70,54.3
"2011","Waltham Forest 027","E02000921","Total",11001,5521,5480,10979,22,92,84.00,131.0
"2011","Waltham Forest 028","E02000922","Total",10523,5628,4895,10471,52,75,65.29,161.2
"2011","Bracknell Forest 001","E02003352","Total",5816,2809,3007,5805,11,157,2473.00,2.4
"2011","Bracknell Forest 002","E02003353","Total",8689,4294,4395,8564,125,205,2097.36,4.1
"2011","Bracknell Forest 003","E02003354","Total",9867,4864,5003,9800,67,184,247.55,39.9
"2011","Bracknell Forest 004","E02003355","Total",6369,3124,3245,6369,0,59,172.13,37.0
"2011","Bracknell Forest 005","E02003356","Total",7022,3339,3683,6589,433,174,1726.83,4.1
"2011","Bracknell Forest 006","E02003357","Total",8924,4446,4478,8924,0,69,226.10,39.5
"2011","Bracknell Forest 007","E02003358","Total",9082,4445,4637,9024,58,87,301.86,30.1
"2011","Bracknell Forest 008","E02003359","Total",6409,3138,3271,6409,0,59,109.78,58.4
"2011","Bracknell Forest 009","E02003360","Total",9493,4632,4861,9493,0,132,543.27,17.5
"2011","Bracknell Forest 010","E02003361","Total",7410,3700,3710,7404,6,86,186.30,39.8
"2011","Bracknell Forest 011","E02003362","Total",6581,3252,3329,6565,16,67,115.88,56.8
"2011","Bracknell Forest 012","E02003363","Total",6692,3378,3314,5854,838,191,482.53,13.9
"2011","Bracknell Forest 013","E02003364","Total",6653,3349,3304,6529,124,100,1437.10,4.6
"2011","Bracknell Forest 014","E02003365","Total",6670,3298,3372,6513,157,116,394.56,16.9
"2011","Bracknell Forest 015","E02003366","Total",7528,4039,3489,6670,858,125,424.29,17.7
"2011","Brighton and Hove 001","E02003491","Total",7726,3703,4023,7679,47,71,318.23,24.3
"2011","Brighton and Hove 002","E02003492","Total",9491,4534,4957,5928,3563,135,602.32,15.8
"2011","Brighton and Hove 003","E02003493","Total",7824,3777,4047,7778,46,90,1028.03,7.6
"2011","Brighton and Hove 004","E02003494","Total",6514,3145,3369,6503,11,138,167.69,38.8
"2011","Brighton and Hove 005","E02003495","Total",7200,3470,3730,7200,0,56,565.64,12.7
"2011","Brighton and Hove 006","E02003496","Total",7430,3501,3929,7430,0,99,570.03,13.0
"2011","Brighton and Hove 007","E02003497","Total",7291,3595,3696,7224,67,166,239.02,30.5
"2011","Brighton and Hove 008","E02003498","Total",8382,4224,4158,8237,145,57,358.62,23.4
"2011","Brighton and Hove 009","E02003499","Total",8022,3921,4101,7986,36,43,306.74,26.2
"2011","Brighton and Hove 010","E02003500","Total",8360,4005,4355,8316,44,151,69.68,120.0
"2011","Brighton and Hove 011","E02003501","Total",8322,4149,4173,8201,121,139,183.43,45.4
"2011","Brighton and Hove 012","E02003502","Total",7574,3685,3889,7451,123,60,122.19,62.0
"2011","Brighton and Hove 013","E02003503","Total",8974,4331,4643,8900,74,104,190.80,47.0
"2011","Brighton and Hove 014","E02003504","Total",8390,4240,4150,8251,139,100,115.19,72.8
"2011","Brighton and Hove 015","E02003505","Total",8984,4451,4533,8970,14,69,57.91,155.1
"2011","Brighton and Hove 016","E02003506","Total",6760,3246,3514,6720,40,56,74.53,90.7
"2011","Brighton and Hove 017","E02003507","Total",9793,4710,5083,9783,10,69,843.38,11.6
"2011","Brighton and Hove 018","E02003508","Total",8741,4298,4443,8734,7,102,86.46,101.1
"2011","Brighton and Hove 019","E02003509","Total",8704,4439,4265,8607,97,62,74.42,117.0
"2011","Brighton and Hove 020","E02003510","Total",8509,4189,4320,8240,269,105,81.55,104.3
"2011","Brighton and Hove 021","E02003511","Total",7986,3779,4207,7941,45,98,160.02,49.9
"2011","Brighton and Hove 022","E02003512","Total",9079,4622,4457,8832,247,86,46.82,193.9
"2011","Brighton and Hove 023","E02003513","Total",6619,3163,3456,6330,289,108,80.11,82.6
"2011","Brighton and Hove 024","E02003514","Total",8437,4471,3966,8407,30,51,45.52,185.3
"2011","Brighton and Hove 025","E02003515","Total",9086,4378,4708,9046,40,50,363.94,25.0
"2011","Brighton and Hove 026","E02003516","Total",8366,4477,3889,8329,37,32,46.80,178.8
"2011","Brighton and Hove 027","E02003517","Total",10818,5827,4991,10412,406,85,135.05,80.1
"2011","Brighton and Hove 028","E02003518","Total",7572,3724,3848,7223,349,37,81.95,92.4
"2011","Brighton and Hove 029","E02003519","Total",8669,4765,3904,8579,90,38,43.91,197.4
"2011","Brighton and Hove 030","E02003520","Total",8645,4669,3976,8568,77,53,64.83,133.3
"2011","Brighton and Hove 031","E02003521","Total",8083,4264,3819,7716,367,46,77.85,103.8
"2011","Brighton and Hove 032","E02003522","Total",7047,3615,3432,6777,270,65,260.94,27.0
"2011","Brighton and Hove 033","E02003523","Total",9971,4741,5230,9761,210,128,803.11,12.4
"2011","Isle of Wight 001","E02003581","Total",7830,3801,4029,7735,95,73,158.46,49.4
"2011","Isle of Wight 002","E02003582","Total",8210,3987,4223,8136,74,120,1111.12,7.4
"2011","Isle of Wight 003","E02003583","Total",6459,3094,3365,6334,125,50,1107.07,5.8
"2011","Isle of Wight 004","E02003584","Total",6233,3079,3154,5925,308,53,135.70,45.9
"2011","Isle of Wight 005","E02003585","Total",6662,3164,3498,6539,123,85,1205.17,5.5
"2011","Isle of Wight 006","E02003586","Total",7664,3666,3998,7461,203,105,1521.38,5.0
"2011","Isle of Wight 007","E02003587","Total",8408,4036,4372,8305,103,71,294.11,28.6
"2011","Isle of Wight 008","E02003588","Total",7463,3886,3577,6659,804,56,2254.88,3.3
"2011","Isle of Wight 009","E02003589","Total",8494,4706,3788,7357,1137,55,743.08,11.4
"2011","Isle of Wight 010","E02003590","Total",7450,3465,3985,7228,222,112,1640.83,4.5
"2011","Isle of Wight 011","E02003591","Total",9226,4428,4798,9111,115,117,2500.06,3.7
"2011","Isle of Wight 012","E02003592","Total",9482,4488,4994,9243,239,98,2750.55,3.4
"2011","Isle of Wight 013","E02003593","Total",5308,2581,2727,5263,45,101,9031.89,0.6
"2011","Isle of Wight 014","E02003594","Total",9219,4444,4775,8871,348,85,1850.66,5.0
"2011","Isle of Wight 015","E02003595","Total",8085,3887,4198,8043,42,101,1996.97,4.0
"2011","Isle of Wight 016","E02003596","Total",8726,4228,4498,8348,378,91,620.56,14.1
"2011","Isle of Wight 017","E02003597","Total",5617,2748,2869,5610,7,74,7520.96,0.7
"2011","Isle of Wight 018","E02003598","Total",7729,3736,3993,7545,184,72,1572.65,4.9
"2011","Medway 001","E02003314","Total",6310,3095,3215,6241,69,50,5176.79,1.2
"2011","Medway 002","E02003315","Total",5556,2809,2747,5550,6,58,2555.74,2.2
"2011","Medway 003","E02003316","Total",9692,4712,4980,9678,14,93,2799.58,3.5
"2011","Medway 004","E02003317","Total",5903,2906,2997,5814,89,82,478.12,12.3
"2011","Medway 005","E02003318","Total",5998,2921,3077,5998,0,74,164.32,36.5
"2011","Medway 006","E02003319","Total",7768,3857,3911,7620,148,57,129.51,60.0
"2011","Medway 007","E02003320","Total",8258,4539,3719,7388,870,92,356.20,23.2
"2011","Medway 008","E02003321","Total",6087,2932,3155,6069,18,50,129.74,46.9
"2011","Medway 009","E02003322","Total",6975,3517,3458,6364,611,62,77.15,90.4
"2011","Medway 010","E02003323","Total",7265,3627,3638,7206,59,49,161.61,45.0
"2011","Medway 011","E02003324","Total",8989,4366,4623,8989,0,32,258.54,34.8
"2011","Medway 012","E02003325","Total",7000,3634,3366,6972,28,54,83.40,83.9
"2011","Medway 013","E02003326","Total",7787,3853,3934,7698,89,58,94.69,82.2
"2011","Medway 014","E02003327","Total",7314,3721,3593,7219,95,88,147.56,49.6
"2011","Medway 015","E02003328","Total",8279,4184,4095,7950,329,63,229.32,36.1
"2011","Medway 016","E02003329","Total",6656,3361,3295,6602,54,49,71.42,93.2
"2011","Medway 017","E02003330","Total",6755,3297,3458,6721,34,61,93.26,72.4
"2011","Medway 018","E02003331","Total",8789,4218,4571,8789,0,63,163.06,53.9
"2011","Medway 019","E02003332","Total",6002,2958,3044,5937,65,76,180.07,33.3
"2011","Medway 020","E02003333","Total",6704,3519,3185,6677,27,35,85.83,78.1
"2011","Medway 021","E02003334","Total",5961,2951,3010,5903,58,58,71.81,83.0
"2011","Medway 022","E02003335","Total",7135,3539,3596,7104,31,43,89.80,79.5
"2011","Medway 023","E02003336","Total",5856,2879,2977,5838,18,68,486.39,12.0
"2011","Medway 024","E02003337","Total",7061,3749,3312,6285,776,93,501.27,14.1
"2011","Medway 025","E02003338","Total",7030,3324,3706,7030,0,38,212.48,33.1
"2011","Medway 026","E02003339","Total",6277,3071,3206,6155,122,81,155.36,40.4
"2011","Medway 027","E02003340","Total",7792,3717,4075,7679,113,65,196.49,39.7
"2011","Medway 028","E02003341","Total",5448,2673,2775,5446,2,59,1513.61,3.6
"2011","Medway 029","E02003342","Total",6270,3067,3203,6240,30,76,117.53,53.3
"2011","Medway 030","E02003343","Total",5954,2884,3070,5937,17,92,292.70,20.3
"2011","Medway 031","E02003344","Total",7022,3399,3623,7022,0,47,500.34,14.0
"2011","Medway 032","E02003345","Total",5903,2938,2965,5903,0,71,399.39,14.8
"2011","Medway 033","E02003346","Total",6228,3027,3201,6184,44,59,239.15,26.0
"2011","Medway 034","E02003347","Total",6228,3068,3160,6228,0,62,118.64,52.5
"2011","Medway 035","E02003348","Total",8003,3910,4093,7922,81,140,410.83,19.5
"2011","Medway 036","E02003349","Total",7478,3622,3856,7445,33,64,161.25,46.4
"2011","Medway 037","E02003350","Total",6291,3083,3208,6284,7,59,133.74,47.0
"2011","Medway 038","E02003351","Total",7901,3898,4003,7901,0,71,166.62,47.4
"2011","Milton Keynes 001","E02003459","Total",8735,4233,4502,8636,99,193,5221.08,1.7
"2011","Milton Keynes 002","E02003460","Total",9234,4534,4700,9186,48,189,12811.09,0.7
"2011","Milton Keynes 003","E02003461","Total",7392,3535,3857,7256,136,104,405.20,18.2
"2011","Milton Keynes 004","E02003462","Total",7726,3812,3914,7694,32,123,333.70,23.2
"2011","Milton Keynes 005","E02003463","Total",6755,3266,3489,6707,48,122,291.93,23.1
"2011","Milton Keynes 006","E02003464","Total",6744,3278,3466,6744,0,36,194.21,34.7
"2011","Milton Keynes 007","E02003465","Total",6215,3040,3175,6200,15,134,350.07,17.8
"2011","Milton Keynes 008","E02003466","Total",7258,3647,3611,7242,16,67,213.62,34.0
"2011","Milton Keynes 009","E02003467","Total",6371,3079,3292,6213,158,86,281.64,22.6
"2011","Milton Keynes 010","E02003468","Total",7382,3576,3806,7327,55,86,556.17,13.3
"2011","Milton Keynes 011","E02003469","Total",5801,2888,2913,5801,0,88,201.37,28.8
"2011","Milton Keynes 012","E02003470","Total",5620,2691,2929,5610,10,38,192.64,29.2
"2011","Milton Keynes 013","E02003471","Total",6565,3342,3223,6556,9,105,183.91,35.7
"2011","Milton Keynes 014","E02003472","Total",8596,4691,3905,8586,10,81,556.04,15.5
"2011","Milton Keynes 015","E02003473","Total",5683,2843,2840,5683,0,123,323.88,17.5
"2011","Milton Keynes 016","E02003474","Total",8643,4357,4286,8613,30,123,414.54,20.8
"2011","Milton Keynes 017","E02003475","Total",14877,7364,7513,14713,164,185,998.94,14.9
"2011","Milton Keynes 018","E02003476","Total",8646,4397,4249,8382,264,66,206.38,41.9
"2011","Milton Keynes 019","E02003477","Total",11382,5880,5502,10860,522,193,1446.96,7.9
"2011","Milton Keynes 020","E02003478","Total",6900,3357,3543,6823,77,129,365.83,18.9
"2011","Milton Keynes 021","E02003479","Total",7436,3777,3659,7436,0,67,179.51,41.4
"2011","Milton Keynes 022","E02003480","Total",8186,4062,4124,8178,8,112,380.73,21.5
"2011","Milton Keynes 023","E02003481","Total",7133,3560,3573,7100,33,45,681.54,10.5
"2011","Milton Keynes 024","E02003482","Total",6229,3055,3174,6138,91,112,1993.16,3.1
"2011","Milton Keynes 025","E02003483","Total",10902,5376,5526,10893,9,192,254.23,42.9
"2011","Milton Keynes 026","E02003484","Total",7243,3502,3741,7221,22,101,197.49,36.7
"2011","Milton Keynes 027","E02003485","Total",8062,3904,4158,8025,37,70,172.60,46.7
"2011","Milton Keynes 028","E02003486","Total",8899,4393,4506,8876,23,130,411.26,21.6
"2011","Milton Keynes 029","E02003487","Total",7231,3481,3750,7231,0,96,206.86,35.0
"2011","Milton Keynes 030","E02003488","Total",7059,3440,3619,7020,39,67,182.78,38.6
"2011","Milton Keynes 031","E02003489","Total",6920,3410,3510,6811,109,83,239.60,28.9
"2011","Milton Keynes 032","E02003490","Total",6996,3346,3650,6954,42,49,413.57,16.9
"2011","Portsmouth 001","E02003524","Total",7989,3910,4079,7986,3,27,188.02,42.5
"2011","Portsmouth 002","E02003525","Total",6239,3002,3237,6207,32,18,201.30,31.0
"2011","Portsmouth 003","E02003526","Total",6509,3166,3343,6392,117,101,226.00,28.8
"2011","Portsmouth 004","E02003527","Total",5869,2887,2982,5869,0,44,383.32,15.3
"2011","Portsmouth 006","E02003529","Total",7743,3783,3960,7637,106,58,149.96,51.6
"2011","Portsmouth 007","E02003530","Total",7525,3584,3941,7467,58,36,169.56,44.4
"2011","Portsmouth 008","E02003531","Total",7949,3914,4035,7945,4,70,384.40,20.7
"2011","Portsmouth 009","E02003532","Total",7538,3781,3757,7506,32,33,78.76,95.7
"2011","Portsmouth 010","E02003533","Total",5570,2703,2867,5548,22,15,135.66,41.1
"2011","Portsmouth 011","E02003534","Total",8817,4401,4416,8817,0,35,83.65,105.4
"2011","Portsmouth 012","E02003535","Total",9491,4674,4817,9482,9,53,64.05,148.2
"2011","Portsmouth 013","E02003536","Total",7513,3650,3863,7496,17,17,115.13,65.3
"2011","Portsmouth 014","E02003537","Total",10468,5239,5229,10250,218,82,151.04,69.3
"2011","Portsmouth 015","E02003538","Total",10207,5196,5011,10164,43,59,96.20,106.1
"2011","Portsmouth 016","E02003539","Total",12367,6480,5887,10185,2182,113,259.27,47.7
"2011","Portsmouth 017","E02003540","Total",9119,4489,4630,8403,716,87,254.77,35.8
"2011","Portsmouth 018","E02003541","Total",11628,5980,5648,11334,294,83,68.92,168.7
"2011","Portsmouth 019","E02003542","Total",9456,4828,4628,9456,0,77,56.77,166.6
"2011","Portsmouth 020","E02003543","Total",8951,4787,4164,8923,28,87,58.08,154.1
"2011","Portsmouth 021","E02003544","Total",6450,3201,3249,6450,0,44,48.41,133.2
"2011","Portsmouth 022","E02003545","Total",7148,3878,3270,6798,350,70,57.19,125.0
"2011","Portsmouth 023","E02003546","Total",8525,4199,4326,8441,84,104,185.15,46.0
"2011","Portsmouth 024","E02003547","Total",8644,4620,4024,8208,436,141,181.56,47.6
"2011","Portsmouth 025","E02003548","Total",6796,3624,3172,6584,212,73,54.20,125.4
"2011","Portsmouth 026","E02006821","Total",6545,3225,3320,6504,41,83,389.77,16.8
"2011","Reading 001","E02003389","Total",7781,3789,3992,7775,6,128,293.09,26.5
"2011","Reading 002","E02003390","Total",7601,3744,3857,7584,17,238,291.38,26.1
"2011","Reading 003","E02003391","Total",8233,3900,4333,7969,264,154,216.01,38.1
"2011","Reading 004","E02003392","Total",8119,4038,4081,8116,3,82,149.58,54.3
"2011","Reading 005","E02003393","Total",7830,3783,4047,7806,24,174,199.41,39.3
"2011","Reading 006","E02003394","Total",7536,3674,3862,7409,127,60,166.60,45.2
"2011","Reading 007","E02003395","Total",9453,4894,4559,9453,0,68,283.52,33.3
"2011","Reading 008","E02003396","Total",9210,4712,4498,9192,18,86,127.17,72.4
"2011","Reading 009","E02003397","Total",7444,3566,3878,7435,9,85,172.94,43.0
"2011","Reading 010","E02003398","Total",10517,5531,4986,10517,0,107,117.01,89.9
"2011","Reading 011","E02003399","Total",11836,6436,5400,11491,345,64,254.26,46.6
"2011","Reading 012","E02003400","Total",8463,4330,4133,8375,88,137,98.76,85.7
"2011","Reading 013","E02003401","Total",8306,4127,4179,7959,347,91,280.83,29.6
"2011","Reading 014","E02003402","Total",9543,4922,4621,8620,923,94,143.35,66.6
"2011","Reading 015","E02003403","Total",8548,4078,4470,8447,101,104,329.74,25.9
"2011","Reading 016","E02003404","Total",7888,3884,4004,5797,2091,139,185.35,42.6
"2011","Reading 017","E02003405","Total",9931,4926,5005,9929,2,60,473.92,21.0
"2011","Reading 018","E02003406","Total",7459,3633,3826,7456,3,56,256.94,29.0
"2011","Slough 001","E02003407","Total",9376,4560,4816,9364,12,80,171.86,54.6
"2011","Slough 002","E02003408","Total",10334,5224,5110,10334,0,98,231.19,44.7
"2011","Slough 003","E02003409","Total",10357,5053,5304,10326,31,101,219.71,47.1
"2011","Slough 004","E02003410","Total",11450,5702,5748,11447,3,95,157.12,72.9
"2011","Slough 005","E02003411","Total",11017,5406,5611,10912,105,86,189.98,58.0
"2011","Slough 006","E02003412","Total",9447,4692,4755,9436,11,74,143.88,65.7
"2011","Slough 007","E02003413","Total",12364,6261,6103,12290,74,135,208.36,59.3
"2011","Slough 008","E02003414","Total",12116,6052,6064,12105,11,114,368.46,32.9
"2011","Slough 009","E02003415","Total",12117,6366,5751,11936,181,97,211.99,57.2
"2011","Slough 010","E02003416","Total",8079,4042,4037,8075,4,135,203.14,39.8
"2011","Slough 011","E02003417","Total",9386,4722,4664,9337,49,149,291.62,32.2
"2011","Slough 012","E02003418","Total",9504,4639,4865,9479,25,145,157.49,60.3
"2011","Slough 013","E02003419","Total",8501,4232,4269,8501,0,77,135.65,62.7
"2011","Slough 014","E02003420","Total",6157,3169,2988,6155,2,56,563.16,10.9
"2011","Southampton 001","E02003549","Total",8453,4327,4126,6633,1820,135,268.96,31.4
"2011","Southampton 002","E02003550","Total",7878,3855,4023,7878,0,50,173.11,45.5
"2011","Southampton 003","E02003551","Total",6655,3371,3284,4841,1814,61,189.40,35.1
"2011","Southampton 004","E02003552","Total",6168,2988,3180,6168,0,21,108.76,56.7
"2011","Southampton 005","E02003553","Total",7009,3726,3283,7009,0,54,109.51,64.0
"2011","Southampton 006","E02003554","Total",6079,3012,3067,5951,128,80,183.99,33.0
"2011","Southampton 007","E02003555","Total",7325,3594,3731,7325,0,43,157.28,46.6
"2011","Southampton 008","E02003556","Total",5941,2956,2985,5941,0,52,155.63,38.2
"2011","Southampton 009","E02003557","Total",6897,3560,3337,6673,224,132,163.99,42.1
"2011","Southampton 010","E02003558","Total",6612,3216,3396,6595,17,46,118.24,55.9
"2011","Southampton 011","E02003559","Total",7813,3797,4016,7752,61,158,246.69,31.7
"2011","Southampton 012","E02003560","Total",7165,3486,3679,7165,0,28,246.70,29.0
"2011","Southampton 013","E02003561","Total",7934,4112,3822,7817,117,38,99.54,79.7
"2011","Southampton 014","E02003562","Total",8085,4133,3952,8025,60,83,144.37,56.0
"2011","Southampton 015","E02003563","Total",7717,3754,3963,7638,79,48,105.67,73.0
"2011","Southampton 016","E02003564","Total",8000,3830,4170,7944,56,60,136.62,58.6
"2011","Southampton 017","E02003565","Total",6622,3508,3114,6533,89,37,61.98,106.8
"2011","Southampton 018","E02003566","Total",6035,2898,3137,6025,10,37,125.51,48.1
"2011","Southampton 019","E02003567","Total",7665,3722,3943,7613,52,45,268.11,28.6
"2011","Southampton 020","E02003568","Total",8509,4586,3923,8034,475,73,95.23,89.4
"2011","Southampton 021","E02003569","Total",7428,3867,3561,7401,27,25,202.40,36.7
"2011","Southampton 022","E02003570","Total",10222,5649,4573,9809,413,66,155.21,65.9
"2011","Southampton 023","E02003571","Total",7164,3725,3439,6743,421,88,158.14,45.3
"2011","Southampton 024","E02003572","Total",6127,3042,3085,6084,43,57,132.95,46.1
"2011","Southampton 025","E02003573","Total",7452,3604,3848,7434,18,35,147.04,50.7
"2011","Southampton 026","E02003574","Total",7757,3823,3934,7752,5,49,156.85,49.5
"2011","Southampton 027","E02003575","Total",6348,3032,3316,6348,0,26,104.77,60.6
"2011","Southampton 028","E02003576","Total",8076,4013,4063,8041,35,28,131.44,61.4
"2011","Southampton 029","E02003577","Total",11598,6420,5178,9365,2233,134,211.96,54.7
"2011","Southampton 030","E02003578","Total",6296,3136,3160,6272,24,41,138.45,45.5
"2011","Southampton 031","E02003579","Total",7822,3798,4024,7637,185,34,174.89,44.7
"2011","Southampton 032","E02003580","Total",6030,2913,3117,6013,17,22,115.54,52.2
"2011","West Berkshire 001","E02003367","Total",6262,3170,3092,5994,268,197,12164.37,0.5
"2011","West Berkshire 002","E02003368","Total",5575,2774,2801,5528,47,121,9182.92,0.6
"2011","West Berkshire 003","E02003369","Total",6081,3007,3074,5853,228,205,4266.16,1.4
"2011","West Berkshire 004","E02003370","Total",6548,3217,3331,6490,58,158,1210.64,5.4
"2011","West Berkshire 005","E02003371","Total",5945,2964,2981,5933,12,123,253.04,23.5
"2011","West Berkshire 006","E02003372","Total",7657,3754,3903,7657,0,130,318.51,24.0
"2011","West Berkshire 007","E02003373","Total",8623,4120,4503,7920,703,209,5688.31,1.5
"2011","West Berkshire 008","E02003374","Total",5728,2825,2903,5717,11,82,168.65,34.0
"2011","West Berkshire 009","E02003375","Total",5788,2836,2952,5777,11,86,2770.61,2.1
"2011","West Berkshire 010","E02003376","Total",5767,2796,2971,5669,98,80,2752.30,2.1
"2011","West Berkshire 011","E02003377","Total",10236,5300,4936,9414,822,275,8825.06,1.2
"2011","West Berkshire 012","E02003378","Total",7725,3751,3974,7680,45,130,1141.50,6.8
"2011","West Berkshire 013","E02003379","Total",6827,3435,3392,6746,81,58,164.34,41.5
"2011","West Berkshire 014","E02003380","Total",7851,3970,3881,7848,3,99,335.64,23.4
"2011","West Berkshire 015","E02003381","Total",5955,2953,3002,5883,72,119,1710.94,3.5
"2011","West Berkshire 016","E02003382","Total",7585,3722,3863,7501,84,80,133.04,57.0
"2011","West Berkshire 017","E02003383","Total",6918,3485,3433,6918,0,141,630.16,11.0
"2011","West Berkshire 018","E02003384","Total",6385,3169,3216,6286,99,215,13278.45,0.5
"2011","West Berkshire 019","E02003385","Total",7536,3756,3780,7468,68,76,1257.64,6.0
"2011","West Berkshire 020","E02003386","Total",7965,3906,4059,7906,59,126,182.49,43.6
"2011","West Berkshire 021","E02003387","Total",9133,4540,4593,9081,52,216,356.12,25.6
"2011","West Berkshire 022","E02003388","Total",5732,2871,2861,5609,123,110,3625.93,1.6
"2011","Windsor and Maidenhead 001","E02003421","Total",5590,2689,2901,5560,30,138,409.02,13.7
"2011","Windsor and Maidenhead 002","E02003422","Total",11490,5660,5830,11311,179,326,7062.16,1.6
"2011","Windsor and Maidenhead 003","E02003423","Total",6067,2988,3079,6046,21,90,115.78,52.4
"2011","Windsor and Maidenhead 004","E02003424","Total",8116,4019,4097,7935,181,213,526.46,15.4
"2011","Windsor and Maidenhead 005","E02003425","Total",10853,5385,5468,10810,43,141,255.32,42.5
"2011","Windsor and Maidenhead 006","E02003426","Total",9586,4590,4996,9447,139,253,352.56,27.2
"2011","Windsor and Maidenhead 007","E02003427","Total",7540,3747,3793,7540,0,94,167.51,45.0
"2011","Windsor and Maidenhead 008","E02003428","Total",9022,4425,4597,9022,0,148,530.20,17.0
"2011","Windsor and Maidenhead 009","E02003429","Total",7483,3717,3766,7341,142,168,2576.97,2.9
"2011","Windsor and Maidenhead 010","E02003430","Total",6713,3895,2818,5500,1213,105,822.57,8.2
"2011","Windsor and Maidenhead 011","E02003431","Total",6596,3242,3354,6556,40,117,1103.17,6.0
"2011","Windsor and Maidenhead 012","E02003432","Total",6758,3424,3334,6490,268,87,239.38,28.2
"2011","Windsor and Maidenhead 013","E02003433","Total",6614,3216,3398,6611,3,81,198.38,33.3
"2011","Windsor and Maidenhead 014","E02003434","Total",8773,4244,4529,8613,160,126,174.14,50.4
"2011","Windsor and Maidenhead 015","E02003435","Total",6911,3357,3554,6893,18,179,908.57,7.6
"2011","Windsor and Maidenhead 016","E02003436","Total",8357,4129,4228,8270,87,171,2277.94,3.7
"2011","Windsor and Maidenhead 017","E02003437","Total",7516,3644,3872,7092,424,198,936.91,8.0
"2011","Windsor and Maidenhead 018","E02003438","Total",10575,4957,5618,10028,547,356,993.92,10.6
"2011","Wokingham 001","E02003439","Total",5421,2668,2753,5288,133,186,3011.63,1.8
"2011","Wokingham 002","E02003440","Total",8833,4334,4499,8786,47,163,617.66,14.3
"2011","Wokingham 003","E02003441","Total",7634,3755,3879,7536,98,160,623.68,12.2
"2011","Wokingham 004","E02003442","Total",7107,3499,3608,7107,0,149,585.77,12.1
"2011","Wokingham 005","E02003443","Total",5974,2963,3011,5942,32,58,174.64,34.2
"2011","Wokingham 006","E02003444","Total",8890,4441,4449,8890,0,209,326.25,27.2
"2011","Wokingham 007","E02003445","Total",8331,4161,4170,7911,420,112,251.07,33.2
"2011","Wokingham 008","E02003446","Total",8488,4260,4228,8072,416,208,296.03,28.7
"2011","Wokingham 009","E02003447","Total",9438,4615,4823,9237,201,186,540.49,17.5
"2011","Wokingham 010","E02003448","Total",6672,3374,3298,6668,4,163,2028.72,3.3
"2011","Wokingham 011","E02003449","Total",7464,3770,3694,7463,1,134,164.66,45.3
"2011","Wokingham 012","E02003450","Total",10638,5229,5409,10593,45,174,728.97,14.6
"2011","Wokingham 013","E02003451","Total",7939,3758,4181,7792,147,96,284.34,27.9
"2011","Wokingham 014","E02003452","Total",6100,3029,3071,6068,32,148,289.08,21.1
"2011","Wokingham 015","E02003453","Total",6512,3174,3338,6512,0,214,605.14,10.8
"2011","Wokingham 016","E02003454","Total",7612,3668,3944,7408,204,180,484.32,15.7
"2011","Wokingham 017","E02003455","Total",6715,3361,3354,6642,73,113,2608.69,2.6
"2011","Wokingham 018","E02003456","Total",6824,3478,3346,6398,426,133,2143.14,3.2
"2011","Wokingham 019","E02003457","Total",9764,4839,4925,9740,24,340,1162.38,8.4
"2011","Wokingham 020","E02003458","Total",8024,4088,3936,7687,337,232,971.26,8.3
"2011","Aylesbury Vale 001","E02003652","Total",8623,4348,4275,7808,815,251,7038.04,1.2
"2011","Aylesbury Vale 002","E02003653","Total",6469,3215,3254,6138,331,133,346.70,18.7
"2011","Aylesbury Vale 003","E02003654","Total",5531,2781,2750,5522,9,154,6580.61,0.8
"2011","Aylesbury Vale 004","E02003655","Total",9456,4694,4762,9421,35,254,14528.43,0.7
"2011","Aylesbury Vale 005","E02003656","Total",5725,2762,2963,5674,51,129,2595.80,2.2
"2011","Aylesbury Vale 006","E02003657","Total",6053,2978,3075,5971,82,173,8433.66,0.7
"2011","Aylesbury Vale 007","E02003658","Total",7041,3449,3592,6901,140,138,6798.14,1.0
"2011","Aylesbury Vale 008","E02003659","Total",8334,4068,4266,8321,13,238,10888.59,0.8
"2011","Aylesbury Vale 009","E02003660","Total",9544,4736,4808,9523,21,216,5924.24,1.6
"2011","Aylesbury Vale 010","E02003661","Total",5750,3096,2654,5202,548,148,9673.56,0.6
"2011","Aylesbury Vale 011","E02003662","Total",6266,3100,3166,6219,47,64,192.05,32.6
"2011","Aylesbury Vale 012","E02003663","Total",5478,2674,2804,5413,65,58,990.45,5.5
"2011","Aylesbury Vale 013","E02003664","Total",6187,3075,3112,6060,127,44,173.68,35.6
"2011","Aylesbury Vale 014","E02003665","Total",5896,3075,2821,5514,382,61,149.40,39.5
"2011","Aylesbury Vale 015","E02003666","Total",6723,3390,3333,6678,45,53,139.25,48.3
"2011","Aylesbury Vale 016","E02003667","Total",9398,4675,4723,9344,54,65,164.03,57.3
"2011","Aylesbury Vale 017","E02003668","Total",8804,4369,4435,8757,47,177,255.26,34.5
"2011","Aylesbury Vale 018","E02003669","Total",6912,3402,3510,6893,19,68,143.78,48.1
"2011","Aylesbury Vale 019","E02003670","Total",8726,4352,4374,8644,82,119,190.61,45.8
"2011","Aylesbury Vale 020","E02003671","Total",5882,2858,3024,5882,0,50,98.59,59.7
"2011","Aylesbury Vale 021","E02003672","Total",9641,4676,4965,9463,178,230,3517.96,2.7
"2011","Aylesbury Vale 022","E02003673","Total",8105,3910,4195,8006,99,195,5086.61,1.6
"2011","Aylesbury Vale 023","E02003674","Total",5259,2559,2700,5257,2,129,3942.38,1.3
"2011","Aylesbury Vale 024","E02003675","Total",8334,3999,4335,8040,294,179,2423.53,3.4
"2011","Chiltern 001","E02003676","Total",8015,3994,4021,7969,46,293,7156.30,1.1
"2011","Chiltern 002","E02003677","Total",9593,4775,4818,9576,17,144,363.75,26.4
"2011","Chiltern 003","E02003678","Total",5518,2718,2800,5474,44,116,379.99,14.5
"2011","Chiltern 004","E02003679","Total",6372,3107,3265,6311,61,57,673.80,9.5
"2011","Chiltern 005","E02003680","Total",10072,4857,5215,9983,89,310,1923.90,5.2
"2011","Chiltern 006","E02003681","Total",10172,4925,5247,10051,121,307,647.97,15.7
"2011","Chiltern 007","E02003682","Total",7329,3600,3729,7306,23,166,1691.37,4.3
"2011","Chiltern 008","E02003683","Total",6292,3019,3273,6285,7,194,910.86,6.9
"2011","Chiltern 010","E02003685","Total",7957,3835,4122,7957,0,267,1297.20,6.1
"2011","Chiltern 011","E02003686","Total",7068,3414,3654,6858,210,216,917.01,7.7
"2011","Chiltern 012","E02003687","Total",5698,2689,3009,5592,106,162,693.37,8.2
"2011","Chiltern 013","E02006823","Total",8549,4116,4433,8509,40,250,2979.29,2.9
"2011","South Bucks 001","E02003688","Total",12081,5853,6228,11786,295,371,1965.50,6.1
"2011","South Bucks 002","E02003689","Total",8693,4181,4512,8525,168,357,1361.12,6.4
"2011","South Bucks 003","E02003690","Total",6463,3146,3317,6374,89,100,1329.31,4.9
"2011","South Bucks 004","E02003691","Total",6857,3293,3564,6665,192,211,1640.75,4.2
"2011","South Bucks 005","E02003692","Total",8476,4162,4314,8328,148,165,2407.16,3.5
"2011","South Bucks 006","E02003693","Total",6205,2983,3222,6105,100,158,3437.21,1.8
"2011","South Bucks 007","E02003694","Total",7846,3761,4085,7837,9,107,212.53,36.9
"2011","South Bucks 008","E02003695","Total",10246,5060,5186,10199,47,170,1773.94,5.8
"2011","Wycombe 001","E02003696","Total",8101,3847,4254,7954,147,168,1064.32,7.6
"2011","Wycombe 002","E02003697","Total",6052,2982,3070,6041,11,172,6116.84,1.0
"2011","Wycombe 003","E02003698","Total",8362,4135,4227,8332,30,258,1878.82,4.5
"2011","Wycombe 004","E02003699","Total",5554,2763,2791,5533,21,95,2666.91,2.1
"2011","Wycombe 006","E02003701","Total",11169,5569,5600,10864,305,177,596.00,18.7
"2011","Wycombe 007","E02003702","Total",8286,4165,4121,7940,346,293,10940.26,0.8
"2011","Wycombe 008","E02003703","Total",7835,3944,3891,7608,227,154,255.35,30.7
"2011","Wycombe 009","E02003704","Total",5919,2921,2998,5909,10,165,432.98,13.7
"2011","Wycombe 010","E02003705","Total",6920,3547,3373,6917,3,84,95.37,72.6
"2011","Wycombe 011","E02003706","Total",6562,3208,3354,6562,0,57,121.42,54.0
"2011","Wycombe 012","E02003707","Total",6214,3169,3045,6197,17,65,337.16,18.4
"2011","Wycombe 013","E02003708","Total",9406,4847,4559,9387,19,107,111.14,84.6
"2011","Wycombe 014","E02003709","Total",5807,2807,3000,5804,3,55,177.47,32.7
"2011","Wycombe 015","E02003710","Total",10365,4987,5378,9299,1066,224,455.80,22.7
"2011","Wycombe 016","E02003711","Total",8486,4247,4239,8475,11,76,419.07,20.2
"2011","Wycombe 017","E02003712","Total",7825,3819,4006,7621,204,100,724.75,10.8
"2011","Wycombe 018","E02003713","Total",5965,2876,3089,5960,5,143,434.63,13.7
"2011","Wycombe 019","E02003714","Total",6627,3194,3433,6595,32,91,728.78,9.1
"2011","Wycombe 020","E02003715","Total",6710,3382,3328,6710,0,227,3278.02,2.0
"2011","Wycombe 021","E02003716","Total",5531,2675,2856,5467,64,116,509.79,10.8
"2011","Wycombe 022","E02003717","Total",8799,4238,4561,8716,83,196,487.51,18.0
"2011","Wycombe 023","E02003718","Total",5526,2644,2882,5518,8,99,201.03,27.5
"2011","Wycombe 024","E02006824","Total",9623,4651,4972,9549,74,202,423.79,22.7
"2011","Eastbourne 001","E02004356","Total",7492,3562,3930,7479,13,73,190.96,39.2
"2011","Eastbourne 002","E02004357","Total",7695,3688,4007,7689,6,40,110.87,69.4
"2011","Eastbourne 003","E02004358","Total",7779,3704,4075,7771,8,50,228.17,34.1
"2011","Eastbourne 004","E02004359","Total",7938,3715,4223,7790,148,74,308.50,25.7
"2011","Eastbourne 006","E02004361","Total",7984,3754,4230,7874,110,110,1015.26,7.9
"2011","Eastbourne 007","E02004362","Total",8723,4203,4520,8684,39,56,204.87,42.6
"2011","Eastbourne 008","E02004363","Total",6728,3186,3542,6203,525,84,265.33,25.4
"2011","Eastbourne 009","E02004364","Total",8214,3814,4400,8041,173,109,143.49,57.2
"2011","Eastbourne 010","E02004365","Total",7420,3792,3628,7342,78,53,79.82,93.0
"2011","Eastbourne 011","E02004366","Total",6898,3378,3520,6321,577,47,117.52,58.7
"2011","Eastbourne 012","E02004367","Total",7070,3216,3854,6333,737,106,1258.47,5.6
"2011","Eastbourne 013","E02006857","Total",8500,4073,4427,8470,30,70,345.46,24.6
"2011","Eastbourne 014","E02006858","Total",6971,3474,3497,6971,0,58,147.17,47.4
"2011","Hastings 001","E02004368","Total",8042,3911,4131,7987,55,95,403.25,19.9
"2011","Hastings 002","E02004369","Total",9682,4614,5068,9473,209,135,399.73,24.2
"2011","Hastings 003","E02004370","Total",7706,3725,3981,7698,8,44,237.16,32.5
"2011","Hastings 004","E02004371","Total",7022,3392,3630,6944,78,40,551.71,12.7
"2011","Hastings 005","E02004372","Total",6495,3063,3432,6495,0,31,147.42,44.1
"2011","Hastings 006","E02004373","Total",8548,4045,4503,8481,67,62,221.20,38.6
"2011","Hastings 007","E02004374","Total",7746,3743,4003,7648,98,88,177.33,43.7
"2011","Hastings 008","E02004375","Total",8552,4261,4291,8341,211,84,179.82,47.6
"2011","Hastings 009","E02004376","Total",6987,3577,3410,6916,71,43,98.66,70.8
"2011","Hastings 010","E02004377","Total",10580,4996,5584,9979,601,88,470.48,22.5
"2011","Hastings 011","E02004378","Total",8894,4687,4207,8600,294,35,85.64,103.9
"2011","Lewes 001","E02004379","Total",7650,3763,3887,7540,110,227,6195.40,1.2
"2011","Lewes 002","E02004380","Total",8786,4231,4555,8451,335,256,11066.11,0.8
"2011","Lewes 003","E02004381","Total",9595,4658,4937,9547,48,140,606.57,15.8
"2011","Lewes 004","E02004382","Total",6422,3112,3310,6361,61,92,7368.59,0.9
"2011","Lewes 005","E02004383","Total",7702,3790,3912,7369,333,161,534.24,14.4
"2011","Lewes 006","E02004384","Total",7477,3630,3847,7375,102,61,472.91,15.8
"2011","Lewes 007","E02004385","Total",7590,3720,3870,7585,5,32,209.14,36.3
"2011","Lewes 008","E02004386","Total",6286,3139,3147,6235,51,49,450.44,14.0
"2011","Lewes 009","E02004387","Total",5946,2955,2991,5928,18,39,267.51,22.2
"2011","Lewes 010","E02004388","Total",6477,3099,3378,6382,95,28,309.66,20.9
"2011","Lewes 011","E02004389","Total",9480,4572,4908,9219,261,102,808.46,11.7
"2011","Lewes 012","E02004390","Total",7853,3725,4128,7834,19,64,689.43,11.4
"2011","Lewes 013","E02004391","Total",6238,2969,3269,6054,184,56,228.64,27.3
"2011","Rother 001","E02004392","Total",9281,4594,4687,8907,374,228,8089.76,1.1
"2011","Rother 002","E02004393","Total",6129,2942,3187,6042,87,94,9662.39,0.6
"2011","Rother 003","E02004394","Total",7826,3845,3981,7571,255,214,12615.58,0.6
"2011","Rother 004","E02004395","Total",7584,3681,3903,7552,32,59,3059.00,2.5
"2011","Rother 005","E02004396","Total",8663,4190,4473,8446,217,142,7701.38,1.1
"2011","Rother 006","E02004397","Total",7998,3801,4197,7790,208,163,6581.03,1.2
"2011","Rother 007","E02004398","Total",8736,4074,4662,8631,105,80,400.24,21.8
"2011","Rother 008","E02004399","Total",7757,3605,4152,7342,415,54,430.56,18.0
"2011","Rother 009","E02004400","Total",10232,4736,5496,10013,219,126,1992.45,5.1
"2011","Rother 010","E02004401","Total",7672,3522,4150,7548,124,91,263.97,29.1
"2011","Rother 011","E02004402","Total",8710,4031,4679,8307,403,62,146.69,59.4
"2011","Wealden 001","E02004403","Total",6483,3119,3364,6330,153,221,5556.52,1.2
"2011","Wealden 002","E02004404","Total",6421,3116,3305,6407,14,201,10102.35,0.6
"2011","Wealden 003","E02004405","Total",5801,2853,2948,5801,0,124,284.25,20.4
"2011","Wealden 004","E02004406","Total",7168,3486,3682,6864,304,155,718.74,10.0
"2011","Wealden 005","E02004407","Total",7795,3716,4079,7642,153,284,7506.36,1.0
"2011","Wealden 006","E02004408","Total",7982,3959,4023,7637,345,120,355.64,22.4
"2011","Wealden 007","E02004409","Total",5588,2749,2839,5223,365,173,7883.87,0.7
"2011","Wealden 008","E02004410","Total",7824,3827,3997,7725,99,211,8448.67,0.9
"2011","Wealden 009","E02004411","Total",8511,4067,4444,8479,32,123,429.50,19.8
"2011","Wealden 010","E02004412","Total",7772,3751,4021,7699,73,125,706.07,11.0
"2011","Wealden 011","E02004413","Total",6831,3340,3491,6658,173,142,5066.16,1.3
"2011","Wealden 012","E02004414","Total",5982,2894,3088,5928,54,116,313.80,19.1
"2011","Wealden 013","E02004415","Total",6149,3044,3105,6063,86,158,8549.08,0.7
"2011","Wealden 014","E02004416","Total",6441,3118,3323,6353,88,128,8543.64,0.8
"2011","Wealden 015","E02004417","Total",5630,2672,2958,5563,67,49,547.21,10.3
"2011","Wealden 016","E02004418","Total",5525,2626,2899,5428,97,53,366.90,15.1
"2011","Wealden 017","E02004419","Total",5931,2752,3179,5849,82,43,923.98,6.4
"2011","Wealden 018","E02004420","Total",10519,5088,5431,10049,470,179,12057.67,0.9
"2011","Wealden 019","E02004421","Total",7655,3589,4066,7489,166,52,703.61,10.9
"2011","Wealden 020","E02004422","Total",9467,4546,4921,9431,36,92,3175.77,3.0
"2011","Wealden 021","E02004423","Total",7440,3495,3945,7421,19,67,1077.15,6.9
"2011","Basingstoke and Deane 001","E02004675","Total",7417,3741,3676,7339,78,100,584.56,12.7
"2011","Basingstoke and Deane 002","E02004676","Total",8007,4035,3972,7973,34,160,2785.87,2.9
"2011","Basingstoke and Deane 003","E02004677","Total",7239,3590,3649,7031,208,310,9039.03,0.8
"2011","Basingstoke and Deane 004","E02004678","Total",7423,3671,3752,7374,49,180,7622.91,1.0
"2011","Basingstoke and Deane 005","E02004679","Total",8424,4170,4254,8318,106,198,6825.42,1.2
"2011","Basingstoke and Deane 006","E02004680","Total",6806,3376,3430,6806,0,138,181.89,37.4
"2011","Basingstoke and Deane 007","E02004681","Total",11249,5518,5731,11233,16,70,339.88,33.1
"2011","Basingstoke and Deane 008","E02004682","Total",7898,3909,3989,7892,6,125,465.53,17.0
"2011","Basingstoke and Deane 009","E02004683","Total",6898,3362,3536,6757,141,52,245.22,28.1
"2011","Basingstoke and Deane 010","E02004684","Total",9141,4534,4607,8948,193,96,345.16,26.5
"2011","Basingstoke and Deane 011","E02004685","Total",6950,3582,3368,6910,40,66,250.91,27.7
"2011","Basingstoke and Deane 012","E02004686","Total",7985,4059,3926,7928,57,79,181.32,44.0
"2011","Basingstoke and Deane 013","E02004687","Total",7075,3444,3631,7012,63,55,236.69,29.9
"2011","Basingstoke and Deane 014","E02004688","Total",7679,3728,3951,7661,18,61,214.26,35.8
"2011","Basingstoke and Deane 015","E02004689","Total",5476,2687,2789,5432,44,131,3077.51,1.8
"2011","Basingstoke and Deane 016","E02004690","Total",7873,3955,3918,7846,27,142,254.91,30.9
"2011","Basingstoke and Deane 017","E02004691","Total",7818,3834,3984,7691,127,208,13041.21,0.6
"2011","Basingstoke and Deane 018","E02004692","Total",7285,3608,3677,7274,11,117,309.55,23.5
"2011","Basingstoke and Deane 019","E02004693","Total",7164,3462,3702,7164,0,62,158.61,45.2
"2011","Basingstoke and Deane 020","E02004694","Total",6748,3279,3469,6689,59,171,8813.89,0.8
"2011","Basingstoke and Deane 021","E02004695","Total",8971,4435,4536,8971,0,175,213.82,42.0
"2011","Basingstoke and Deane 022","E02004696","Total",6273,3137,3136,6219,54,147,8192.59,0.8
"2011","East Hampshire 001","E02004697","Total",5856,2809,3047,5524,332,227,7896.78,0.7
"2011","East Hampshire 002","E02004698","Total",5565,2693,2872,5474,91,50,162.12,34.3
"2011","East Hampshire 003","E02004699","Total",10633,5172,5461,10525,108,168,662.65,16.0
"2011","East Hampshire 004","E02004700","Total",5858,3018,2840,5586,272,86,1486.71,3.9
"2011","East Hampshire 006","E02004702","Total",8199,4067,4132,8129,70,90,199.15,41.2
"2011","East Hampshire 007","E02004703","Total",10669,5268,5401,10582,87,345,10797.62,1.0
"2011","East Hampshire 008","E02004704","Total",5672,2802,2870,5662,10,135,5772.45,1.0
"2011","East Hampshire 009","E02004705","Total",8491,4103,4388,8389,102,242,2606.79,3.3
"2011","East Hampshire 010","E02004706","Total",7583,3579,4004,7246,337,161,3026.52,2.5
"2011","East Hampshire 011","E02004707","Total",11539,5563,5976,10972,567,389,12083.83,1.0
"2011","East Hampshire 012","E02004708","Total",8621,4101,4520,8609,12,110,522.03,16.5
"2011","East Hampshire 013","E02004709","Total",7388,3633,3755,7379,9,103,2244.37,3.3
"2011","East Hampshire 014","E02004710","Total",6387,3094,3293,6383,4,105,1080.88,5.9
"2011","East Hampshire 016","E02006829","Total",6551,3155,3396,6423,128,130,1756.81,3.7
"2011","East Hampshire 017","E02006838","Total",6596,3180,3416,6511,85,149,1145.44,5.8
"2011","Eastleigh 001","E02004712","Total",8801,4264,4537,8664,137,201,342.99,25.7
"2011","Eastleigh 002","E02004713","Total",7845,3849,3996,7845,0,91,302.27,26.0
"2011","Eastleigh 003","E02004714","Total",7705,3760,3945,7632,73,122,258.92,29.8
"2011","Eastleigh 004","E02004715","Total",8055,4038,4017,8046,9,55,282.71,28.5
"2011","Eastleigh 005","E02004716","Total",8816,4353,4463,8780,36,81,420.62,21.0
"2011","Eastleigh 006","E02004717","Total",9682,4647,5035,9613,69,37,721.83,13.4
"2011","Eastleigh 007","E02004718","Total",8883,4483,4400,8851,32,50,289.55,30.7
"2011","Eastleigh 008","E02004719","Total",10081,5049,5032,10033,48,127,997.21,10.1
"2011","Eastleigh 009","E02004720","Total",10761,5234,5527,10609,152,131,1213.75,8.9
"2011","Eastleigh 010","E02004721","Total",9233,4522,4711,9204,29,102,633.10,14.6
"2011","Eastleigh 011","E02004722","Total",7221,3437,3784,7135,86,66,440.80,16.4
"2011","Eastleigh 012","E02004723","Total",9419,4591,4828,9282,137,95,483.50,19.5
"2011","Eastleigh 013","E02004724","Total",7664,3714,3950,7629,35,74,705.35,10.9
"2011","Eastleigh 014","E02004725","Total",5332,2578,2754,5246,86,40,205.12,26.0
"2011","Eastleigh 015","E02004726","Total",5701,2865,2836,5697,4,49,680.04,8.4
"2011","Fareham 001","E02004727","Total",9013,4519,4494,8847,166,148,848.88,10.6
"2011","Fareham 002","E02004728","Total",8559,4200,4359,8480,79,108,333.66,25.7
"2011","Fareham 003","E02004729","Total",7401,3569,3832,7357,44,77,196.08,37.7
"2011","Fareham 004","E02004730","Total",8740,4299,4441,8558,182,148,1238.01,7.1
"2011","Fareham 005","E02004731","Total",7900,3883,4017,7871,29,136,263.42,30.0
"2011","Fareham 006","E02004732","Total",8168,4080,4088,7923,245,146,900.78,9.1
"2011","Fareham 007","E02004733","Total",7364,3657,3707,7319,45,132,1097.99,6.7
"2011","Fareham 008","E02004734","Total",10202,5014,5188,9978,224,120,540.04,18.9
"2011","Fareham 009","E02004735","Total",7518,3677,3841,7396,122,89,228.63,32.9
"2011","Fareham 010","E02004736","Total",7847,3855,3992,7820,27,72,296.90,26.4
"2011","Fareham 011","E02004737","Total",7430,3632,3798,7375,55,47,191.40,38.8
"2011","Fareham 012","E02004738","Total",7362,3587,3775,7362,0,63,188.25,39.1
"2011","Fareham 013","E02004739","Total",6907,3304,3603,6727,180,85,782.40,8.8
"2011","Fareham 014","E02004740","Total",7170,3358,3812,7112,58,152,316.83,22.6
"2011","Gosport 001","E02004741","Total",7755,3804,3951,7755,0,43,232.72,33.3
"2011","Gosport 002","E02004742","Total",7494,3671,3823,7491,3,36,281.95,26.6
"2011","Gosport 003","E02004743","Total",7631,3799,3832,7622,9,80,249.06,30.6
"2011","Gosport 004","E02004744","Total",8667,4227,4440,8605,62,51,230.73,37.6
"2011","Gosport 005","E02004745","Total",9024,4535,4489,8998,26,44,125.45,71.9
"2011","Gosport 006","E02004746","Total",10860,5253,5607,10746,114,152,472.63,23.0
"2011","Gosport 007","E02004747","Total",6591,3293,3298,6526,65,52,213.51,30.9
"2011","Gosport 008","E02004748","Total",9594,4860,4734,9517,77,45,185.25,51.8
"2011","Gosport 009","E02004749","Total",7149,3451,3698,6948,201,128,232.94,30.7
"2011","Gosport 010","E02004750","Total",7857,3843,4014,7558,299,115,307.85,25.5
"2011","Hart 001","E02004751","Total",8164,3956,4208,8162,2,155,521.87,15.6
"2011","Hart 002","E02004752","Total",8318,4094,4224,8313,5,167,1611.82,5.2
"2011","Hart 003","E02004753","Total",10115,5099,5016,10003,112,112,1393.72,7.3
"2011","Hart 004","E02004754","Total",6054,2959,3095,6044,10,173,5370.88,1.1
"2011","Hart 005","E02004755","Total",11608,5775,5833,11533,75,175,812.85,14.3
"2011","Hart 006","E02004756","Total",8334,4124,4210,8220,114,243,1764.89,4.7
"2011","Hart 007","E02004757","Total",8057,4030,4027,8031,26,216,287.94,28.0
"2011","Hart 008","E02004758","Total",7884,3898,3986,7705,179,197,3256.43,2.4
"2011","Hart 009","E02004759","Total",8107,3924,4183,8007,100,116,370.68,21.9
"2011","Hart 010","E02004760","Total",7751,3770,3981,7689,62,207,2860.99,2.7
"2011","Hart 011","E02004761","Total",6641,3545,3096,5662,979,173,3274.46,2.0
"2011","Havant 003","E02004764","Total",7850,3848,4002,7790,60,58,235.23,33.4
"2011","Havant 004","E02004765","Total",6016,2944,3072,6011,5,91,211.65,28.4
"2011","Havant 005","E02004766","Total",6424,3052,3372,6304,120,38,170.06,37.8
"2011","Havant 006","E02004767","Total",5896,2832,3064,5861,35,20,285.28,20.7
"2011","Havant 007","E02004768","Total",5591,2748,2843,5562,29,43,148.46,37.7
"2011","Havant 008","E02004769","Total",6407,3088,3319,6388,19,19,268.60,23.9
"2011","Havant 009","E02004770","Total",6910,3392,3518,6906,4,20,156.72,44.1
"2011","Havant 010","E02004771","Total",8968,4326,4642,8968,0,23,170.54,52.6
"2011","Havant 011","E02004772","Total",9171,4504,4667,9118,53,91,361.97,25.3
"2011","Havant 013","E02004774","Total",9492,4522,4970,9278,214,148,482.20,19.7
"2011","Havant 014","E02004775","Total",8882,4299,4583,8744,138,130,729.26,12.2
"2011","Havant 015","E02004776","Total",5977,2935,3042,5793,184,83,1122.71,5.3
"2011","Havant 016","E02004777","Total",5384,2521,2863,5275,109,42,196.10,27.5
"2011","Havant 017","E02004778","Total",6018,2934,3084,5864,154,35,270.66,22.2
"2011","Havant 018","E02006822","Total",8763,4313,4450,8672,91,90,422.87,20.7
"2011","Havant 019","E02006830","Total",6711,3321,3390,6700,11,44,126.39,53.1
"2011","Havant 020","E02006831","Total",6224,3028,3196,6188,36,49,178.27,34.9
"2011","New Forest 001","E02004779","Total",10876,5293,5583,10679,197,235,13887.60,0.8
"2011","New Forest 002","E02004780","Total",6023,2947,3076,6000,23,48,130.69,46.1
"2011","New Forest 003","E02004781","Total",8258,4092,4166,8147,111,82,294.20,28.1
"2011","New Forest 004","E02004782","Total",7650,3769,3881,7575,75,67,559.84,13.7
"2011","New Forest 005","E02004783","Total",7039,3412,3627,7037,2,80,200.91,35.0
"2011","New Forest 006","E02004784","Total",5764,2810,2954,5430,334,71,2148.56,2.7
"2011","New Forest 007","E02004785","Total",5544,2706,2838,5344,200,96,10122.02,0.5
"2011","New Forest 008","E02004786","Total",8817,4335,4482,8696,121,105,1375.50,6.4
"2011","New Forest 009","E02004787","Total",7377,3582,3795,7372,5,66,366.11,20.1
"2011","New Forest 010","E02004788","Total",7195,3505,3690,7071,124,132,6088.93,1.2
"2011","New Forest 011","E02004789","Total",10473,5096,5377,10399,74,115,330.59,31.7
"2011","New Forest 012","E02004790","Total",7688,3635,4053,7570,118,80,1421.62,5.4
"2011","New Forest 013","E02004791","Total",5602,2652,2950,5594,8,33,235.13,23.8
"2011","New Forest 014","E02004792","Total",8685,4297,4388,8640,45,80,2631.20,3.3
"2011","New Forest 015","E02004793","Total",7433,3520,3913,7100,333,170,6559.69,1.1
"2011","New Forest 016","E02004794","Total",6919,3306,3613,6760,159,139,8716.72,0.8
"2011","New Forest 017","E02004795","Total",8426,4002,4424,8258,168,175,14896.10,0.6
"2011","New Forest 018","E02004796","Total",9641,4568,5073,9587,54,111,1862.79,5.2
"2011","New Forest 019","E02004797","Total",7853,3742,4111,7853,0,77,577.12,13.6
"2011","New Forest 020","E02004798","Total",6135,2908,3227,6075,60,63,239.21,25.6
"2011","New Forest 021","E02004799","Total",7960,3656,4304,7707,253,58,280.74,28.4
"2011","New Forest 022","E02004800","Total",7457,3385,4072,7145,312,68,694.05,10.7
"2011","New Forest 023","E02004801","Total",7647,3566,4081,7452,195,131,1694.16,4.5
"2011","Rushmoor 001","E02004802","Total",6854,3294,3560,6752,102,61,169.15,40.5
"2011","Rushmoor 002","E02004803","Total",7552,3611,3941,7546,6,86,108.48,69.6
"2011","Rushmoor 003","E02004804","Total",7213,3618,3595,7213,0,74,165.40,43.6
"2011","Rushmoor 004","E02004805","Total",8260,4062,4198,8171,89,166,313.54,26.3
"2011","Rushmoor 005","E02004806","Total",8173,3997,4176,8173,0,141,282.71,28.9
"2011","Rushmoor 006","E02004807","Total",9052,4471,4581,9043,9,76,249.23,36.3
"2011","Rushmoor 007","E02004808","Total",10382,5243,5139,10176,206,154,1054.70,9.8
"2011","Rushmoor 008","E02004809","Total",8816,4918,3898,7520,1296,92,1028.06,8.6
"2011","Rushmoor 009","E02004810","Total",7539,3767,3772,7533,6,42,140.17,53.8
"2011","Rushmoor 010","E02004811","Total",7449,3635,3814,7339,110,61,133.85,55.7
"2011","Rushmoor 011","E02004812","Total",6474,3203,3271,6419,55,74,117.73,55.0
"2011","Rushmoor 012","E02004813","Total",6043,2938,3105,6005,38,41,141.44,42.7
"2011","Test Valley 001","E02004814","Total",7043,3449,3594,7022,21,156,6990.90,1.0
"2011","Test Valley 002","E02004815","Total",7623,3719,3904,7612,11,50,127.49,59.8
"2011","Test Valley 003","E02004816","Total",9139,4440,4699,8966,173,83,2102.36,4.3
"2011","Test Valley 004","E02004817","Total",7762,3813,3949,7616,146,84,226.46,34.3
"2011","Test Valley 005","E02004818","Total",10164,4976,5188,10070,94,219,3125.09,3.3
"2011","Test Valley 006","E02004819","Total",7898,3862,4036,7644,254,124,234.20,33.7
"2011","Test Valley 007","E02004820","Total",7371,3722,3649,7091,280,224,8582.49,0.9
"2011","Test Valley 008","E02004821","Total",5238,2572,2666,5129,109,169,11030.57,0.5
"2011","Test Valley 009","E02004822","Total",7898,3899,3999,7794,104,262,17842.43,0.4
"2011","Test Valley 010","E02004823","Total",8969,4332,4637,8901,68,137,216.94,41.3
"2011","Test Valley 011","E02004824","Total",5799,2642,3157,5714,85,86,206.63,28.1
"2011","Test Valley 012","E02004825","Total",10631,5162,5469,10505,126,180,2978.28,3.6
"2011","Test Valley 013","E02004826","Total",6809,3375,3434,6420,389,170,6604.79,1.0
"2011","Test Valley 014","E02004827","Total",7713,3805,3908,7713,0,191,259.99,29.7
"2011","Test Valley 015","E02004828","Total",6341,3112,3229,6281,60,149,2229.37,2.8
"2011","Winchester 001","E02004829","Total",5644,2745,2899,5617,27,165,7738.63,0.7
"2011","Winchester 002","E02004830","Total",6331,3117,3214,6203,128,178,8165.40,0.8
"2011","Winchester 003","E02004831","Total",8784,4255,4529,8163,621,280,4365.34,2.0
"2011","Winchester 004","E02004832","Total",8630,4163,4467,8499,131,260,9611.54,0.9
"2011","Winchester 005","E02004833","Total",9725,4718,5007,8537,1188,257,351.12,27.7
"2011","Winchester 006","E02004834","Total",7446,3342,4104,6843,603,105,374.90,19.9
"2011","Winchester 007","E02004835","Total",10086,5307,4779,8998,1088,307,439.30,23.0
"2011","Winchester 008","E02004836","Total",6336,2868,3468,5886,450,94,126.20,50.2
"2011","Winchester 009","E02004837","Total",7594,3708,3886,7554,40,223,4660.81,1.6
"2011","Winchester 010","E02004838","Total",9053,4393,4660,8911,142,262,6119.35,1.5
"2011","Winchester 011","E02004839","Total",8151,3957,4194,8124,27,298,12103.96,0.7
"2011","Winchester 012","E02004840","Total",9459,4536,4923,9399,60,172,2325.43,4.1
"2011","Winchester 013","E02004841","Total",11131,5511,5620,10833,298,187,5003.54,2.2
"2011","Winchester 014","E02004842","Total",8225,4009,4216,7975,250,143,4711.94,1.7
"2011","Ashford 001","E02004996","Total",7956,3848,4108,7917,39,129,8409.73,0.9
"2011","Ashford 002","E02004997","Total",7545,3635,3910,7478,67,130,9213.53,0.8
"2011","Ashford 003","E02004998","Total",6680,3245,3435,6634,46,75,443.20,15.1
"2011","Ashford 004","E02004999","Total",12536,6073,6463,12482,54,126,635.67,19.7
"2011","Ashford 005","E02005000","Total",9580,4756,4824,9385,195,80,354.08,27.1
"2011","Ashford 006","E02005001","Total",8890,4293,4597,8777,113,105,496.21,17.9
"2011","Ashford 007","E02005002","Total",8958,4344,4614,8920,38,63,209.00,42.9
"2011","Ashford 008","E02005003","Total",8553,4141,4412,8525,28,61,182.08,47.0
"2011","Ashford 009","E02005004","Total",12098,5957,6141,12001,97,107,467.94,25.9
"2011","Ashford 010","E02005005","Total",7432,3619,3813,7340,92,129,9636.34,0.8
"2011","Ashford 011","E02005006","Total",5459,2701,2758,5444,15,133,6609.25,0.8
"2011","Ashford 012","E02005007","Total",8552,4166,4386,8493,59,135,7799.46,1.1
"2011","Ashford 013","E02005008","Total",8110,3762,4348,8012,98,146,5255.10,1.5
"2011","Ashford 014","E02005009","Total",5607,2692,2915,5585,22,105,8350.08,0.7
"2011","Canterbury 001","E02005010","Total",7470,3542,3928,7088,382,68,126.77,58.9
"2011","Canterbury 002","E02005011","Total",7353,3459,3894,7175,178,60,878.49,8.4
"2011","Canterbury 003","E02005012","Total",8682,4161,4521,8574,108,80,249.25,34.8
"2011","Canterbury 004","E02005013","Total",8147,3906,4241,8101,46,59,829.12,9.8
"2011","Canterbury 005","E02005014","Total",8463,4012,4451,8427,36,121,994.32,8.5
"2011","Canterbury 006","E02005015","Total",8440,4144,4296,8329,111,87,1096.64,7.7
"2011","Canterbury 007","E02005016","Total",7748,3644,4104,7686,62,92,272.58,28.4
"2011","Canterbury 008","E02005017","Total",7208,3386,3822,7050,158,65,167.70,43.0
"2011","Canterbury 009","E02005018","Total",7945,3861,4084,7923,22,76,1489.71,5.3
"2011","Canterbury 010","E02005019","Total",6020,2890,3130,5832,188,102,5923.22,1.0
"2011","Canterbury 011","E02005020","Total",7129,3476,3653,7042,87,75,1513.93,4.7
"2011","Canterbury 012","E02005021","Total",10478,5052,5426,6296,4182,251,3384.78,3.1
"2011","Canterbury 013","E02005022","Total",8317,4061,4256,8306,11,106,211.91,39.2
"2011","Canterbury 014","E02005023","Total",8971,4388,4583,7819,1152,117,342.37,26.2
"2011","Canterbury 016","E02005025","Total",9015,4374,4641,8173,842,200,677.96,13.3
"2011","Canterbury 017","E02005026","Total",7430,3634,3796,7417,13,122,6205.88,1.2
"2011","Canterbury 018","E02005027","Total",5515,2615,2900,5306,209,127,6064.74,0.9
"2011","Canterbury 019","E02006855","Total",5941,2843,3098,5744,197,69,245.24,24.2
"2011","Canterbury 020","E02006856","Total",10873,5190,5683,10274,599,128,210.58,51.6
"2011","Dartford 001","E02005028","Total",7404,3536,3868,7380,24,30,656.24,11.3
"2011","Dartford 002","E02005029","Total",9352,4710,4642,9268,84,83,758.20,12.3
"2011","Dartford 003","E02005030","Total",9811,4949,4862,9774,37,111,250.77,39.1
"2011","Dartford 004","E02005031","Total",7468,3707,3761,7436,32,32,162.80,45.9
"2011","Dartford 005","E02005032","Total",8962,4591,4371,8896,66,64,156.58,57.2
"2011","Dartford 006","E02005033","Total",6553,3276,3277,6529,24,25,494.00,13.3
"2011","Dartford 007","E02005034","Total",7666,3783,3883,7644,22,152,283.27,27.1
"2011","Dartford 008","E02005035","Total",7999,3967,4032,7762,237,78,509.42,15.7
"2011","Dartford 009","E02005036","Total",6307,3011,3296,6304,3,57,153.91,41.0
"2011","Dartford 010","E02005037","Total",7012,3425,3587,6955,57,102,521.26,13.5
"2011","Dartford 011","E02005038","Total",5793,2799,2994,5666,127,67,741.45,7.8
"2011","Dartford 012","E02005039","Total",6792,3306,3486,6665,127,62,1317.70,5.2
"2011","Dartford 013","E02005040","Total",6246,3001,3245,6097,149,134,1271.25,4.9
"2011","Dover 001","E02005041","Total",7011,3452,3559,6906,105,128,6572.10,1.1
"2011","Dover 002","E02005042","Total",8957,4327,4630,8806,151,140,3899.18,2.3
"2011","Dover 003","E02005043","Total",7445,3519,3926,7249,196,89,251.46,29.6
"2011","Dover 004","E02005044","Total",6847,3393,3454,6759,88,57,124.32,55.1
"2011","Dover 005","E02005045","Total",7988,3845,4143,7905,83,70,2272.73,3.5
"2011","Dover 006","E02005046","Total",6498,3143,3355,6485,13,49,2055.08,3.2
"2011","Dover 007","E02005047","Total",7610,3615,3995,7463,147,75,268.11,28.4
"2011","Dover 008","E02005048","Total",6531,3197,3334,6381,150,83,6080.46,1.1
"2011","Dover 009","E02005049","Total",6929,3335,3594,6798,131,105,2970.71,2.3
"2011","Dover 010","E02005050","Total",9126,4459,4667,8883,243,114,1680.03,5.4
"2011","Dover 011","E02005051","Total",13316,6557,6759,13293,23,79,462.59,28.8
"2011","Dover 012","E02005052","Total",7884,4051,3833,7322,562,71,1213.95,6.5
"2011","Dover 013","E02005053","Total",8901,4576,4325,8625,276,73,462.49,19.2
"2011","Dover 014","E02005054","Total",6631,3296,3335,6587,44,78,3171.88,2.1
"2011","Gravesham 001","E02005055","Total",7803,3849,3954,7743,60,53,299.13,26.1
"2011","Gravesham 002","E02005056","Total",10022,5239,4783,9815,207,88,140.97,71.1
"2011","Gravesham 003","E02005057","Total",10609,5335,5274,10572,37,101,571.73,18.6
"2011","Gravesham 004","E02005058","Total",7717,3762,3955,7682,35,64,96.55,79.9
"2011","Gravesham 005","E02005059","Total",9908,4918,4990,9822,86,138,177.52,55.8
"2011","Gravesham 006","E02005060","Total",7364,3524,3840,7205,159,53,270.48,27.2
"2011","Gravesham 007","E02005061","Total",7126,3468,3658,7126,0,74,118.57,60.1
"2011","Gravesham 008","E02005062","Total",6982,3420,3562,6982,0,66,280.82,24.9
"2011","Gravesham 009","E02005063","Total",6606,3181,3425,6566,40,71,231.56,28.5
"2011","Gravesham 010","E02005064","Total",6672,3228,3444,6581,91,90,3606.77,1.8
"2011","Gravesham 011","E02005065","Total",7221,3499,3722,7221,0,43,130.76,55.2
"2011","Gravesham 012","E02005066","Total",7794,3781,4013,7765,29,130,1831.96,4.3
"2011","Gravesham 013","E02005067","Total",5896,2935,2961,5896,0,95,2145.05,2.7
"2011","Maidstone 001","E02005068","Total",7042,3490,3552,6967,75,138,4074.59,1.7
"2011","Maidstone 002","E02005069","Total",8569,4214,4355,8462,107,115,184.90,46.3
"2011","Maidstone 003","E02005070","Total",8593,4145,4448,8483,110,129,316.52,27.1
"2011","Maidstone 004","E02005071","Total",10403,5689,4714,9486,917,79,254.72,40.8
"2011","Maidstone 005","E02005072","Total",7623,3745,3878,7613,10,158,355.16,21.5
"2011","Maidstone 006","E02005073","Total",10603,5295,5308,10279,324,112,226.22,46.9
"2011","Maidstone 007","E02005074","Total",7979,3850,4129,7903,76,152,251.04,31.8
"2011","Maidstone 008","E02005075","Total",9461,4612,4849,9274,187,130,301.78,31.4
"2011","Maidstone 009","E02005076","Total",8579,4156,4423,8460,119,75,251.78,34.1
"2011","Maidstone 010","E02005077","Total",7831,3854,3977,7795,36,63,362.87,21.6
"2011","Maidstone 011","E02005078","Total",7928,3930,3998,7876,52,109,9890.36,0.8
"2011","Maidstone 012","E02005079","Total",7870,3814,4056,7819,51,81,575.53,13.7
"2011","Maidstone 013","E02005080","Total",11004,5222,5782,10909,95,46,212.61,51.8
"2011","Maidstone 014","E02005081","Total",6599,3233,3366,6594,5,101,2895.54,2.3
"2011","Maidstone 015","E02005082","Total",9543,4702,4841,9465,78,142,3875.07,2.5
"2011","Maidstone 016","E02005083","Total",6741,3316,3425,6669,72,92,735.52,9.2
"2011","Maidstone 017","E02005084","Total",6443,3119,3324,6230,213,99,6041.11,1.1
"2011","Maidstone 018","E02005085","Total",6385,3196,3189,6356,29,140,6142.55,1.0
"2011","Maidstone 019","E02005086","Total",5947,2910,3037,5805,142,105,2385.47,2.5
"2011","Sevenoaks 001","E02005087","Total",6972,3388,3584,6970,2,103,585.05,11.9
"2011","Sevenoaks 002","E02005088","Total",8998,4283,4715,8998,0,70,217.47,41.4
"2011","Sevenoaks 003","E02005089","Total",6257,3067,3190,6256,1,68,1112.97,5.6
"2011","Sevenoaks 004","E02005090","Total",5835,2816,3019,5723,112,102,1314.72,4.4
"2011","Sevenoaks 005","E02005091","Total",6625,3194,3431,6579,46,97,3471.12,1.9
"2011","Sevenoaks 007","E02005093","Total",6062,2992,3070,6029,33,75,2260.73,2.7
"2011","Sevenoaks 008","E02005094","Total",8457,4160,4297,8436,21,153,3640.40,2.3
"2011","Sevenoaks 009","E02005095","Total",7420,3585,3835,7373,47,133,1422.21,5.2
"2011","Sevenoaks 010","E02005096","Total",9508,4606,4902,9400,108,155,513.64,18.5
"2011","Sevenoaks 011","E02005097","Total",9395,4609,4786,9206,189,294,2171.61,4.3
"2011","Sevenoaks 012","E02005098","Total",9791,4729,5062,9267,524,363,3485.64,2.8
"2011","Sevenoaks 013","E02005099","Total",7781,3802,3979,7718,63,176,5415.07,1.4
"2011","Sevenoaks 014","E02005100","Total",8907,4274,4633,8811,96,98,2202.44,4.0
"2011","Sevenoaks 015","E02005101","Total",6720,3270,3450,6695,25,241,8443.71,0.8
"2011","Sevenoaks 016","E02006832","Total",6165,2968,3197,6161,4,81,663.08,9.3
"2011","Shepway 001","E02005102","Total",6275,3053,3222,6251,24,148,8211.44,0.8
"2011","Shepway 002","E02005103","Total",9524,4675,4849,9507,17,97,1299.69,7.3
"2011","Shepway 003","E02005104","Total",8348,4003,4345,8348,0,60,428.85,19.5
"2011","Shepway 004","E02005105","Total",7745,3831,3914,7695,50,43,76.48,101.3
"2011","Shepway 005","E02005106","Total",9093,4398,4695,9093,0,58,354.12,25.7
"2011","Shepway 006","E02005107","Total",12263,6088,6175,11874,389,165,462.71,26.5
"2011","Shepway 008","E02005109","Total",6562,3069,3493,6306,256,96,3326.72,2.0
"2011","Shepway 009","E02005110","Total",6772,3293,3479,6709,63,93,2902.41,2.3
"2011","Shepway 010","E02005111","Total",7260,3402,3858,7157,103,56,284.83,25.5
"2011","Shepway 011","E02005112","Total",6946,3379,3567,6836,110,72,12619.28,0.6
"2011","Shepway 012","E02005113","Total",6996,3384,3612,6781,215,66,641.45,10.9
"2011","Shepway 013","E02005114","Total",6567,3337,3230,6487,80,37,4824.05,1.4
"2011","Shepway 014","E02006879","Total",6698,3730,2968,6628,70,31,87.83,76.3
"2011","Shepway 015","E02006880","Total",6920,3493,3427,6479,441,49,150.45,46.0
"2011","Swale 001","E02005115","Total",5842,2888,2954,5773,69,42,96.26,60.7
"2011","Swale 002","E02005116","Total",6096,2970,3126,6076,20,24,384.77,15.8
"2011","Swale 003","E02005117","Total",5889,2859,3030,5805,84,48,407.01,14.5
"2011","Swale 004","E02005118","Total",9097,4477,4620,9030,67,66,502.56,18.1
"2011","Swale 005","E02005119","Total",5702,2819,2883,5690,12,37,3010.99,1.9
"2011","Swale 006","E02005120","Total",7665,4431,3234,6369,1296,39,4685.08,1.6
"2011","Swale 007","E02005121","Total",12384,6059,6325,12334,50,96,1773.27,7.0
"2011","Swale 008","E02005122","Total",6958,3361,3597,6886,72,86,3041.28,2.3
"2011","Swale 009","E02005123","Total",10927,5417,5510,10809,118,98,1524.51,7.2
"2011","Swale 010","E02005124","Total",8239,4028,4211,8174,65,59,287.74,28.6
"2011","Swale 011","E02005125","Total",7541,3716,3825,7534,7,63,406.10,18.6
"2011","Swale 012","E02005126","Total",7723,3748,3975,7644,79,63,206.27,37.4
"2011","Swale 013","E02005127","Total",8719,4298,4421,8594,125,131,2995.58,2.9
"2011","Swale 014","E02005128","Total",8300,4039,4261,8254,46,86,604.71,13.7
"2011","Swale 015","E02005129","Total",11016,5257,5759,10897,119,105,510.99,21.6
"2011","Swale 016","E02005130","Total",8111,4059,4052,8015,96,104,10508.47,0.8
"2011","Swale 017","E02005131","Total",5626,2726,2900,5496,130,88,6392.96,0.9
"2011","Thanet 001","E02005132","Total",9553,4804,4749,9172,381,66,105.23,90.8
"2011","Thanet 002","E02005133","Total",8415,3989,4426,8283,132,105,463.39,18.2
"2011","Thanet 003","E02005134","Total",7174,3604,3570,6963,211,49,128.52,55.8
"2011","Thanet 004","E02005135","Total",7698,3712,3986,7582,116,45,309.14,24.9
"2011","Thanet 005","E02005136","Total",7844,3799,4045,7751,93,87,328.24,23.9
"2011","Thanet 006","E02005137","Total",7769,3644,4125,7769,0,44,193.80,40.1
"2011","Thanet 007","E02005138","Total",8453,3939,4514,8162,291,59,373.06,22.7
"2011","Thanet 008","E02005139","Total",8504,3939,4565,8409,95,88,577.16,14.7
"2011","Thanet 009","E02005140","Total",7524,3499,4025,7386,138,113,221.46,34.0
"2011","Thanet 010","E02005141","Total",6920,3357,3563,6587,333,104,195.02,35.5
"2011","Thanet 011","E02005142","Total",7227,3423,3804,7069,158,61,529.19,13.7
"2011","Thanet 012","E02005143","Total",8143,3875,4268,8104,39,86,165.68,49.1
"2011","Thanet 013","E02005144","Total",8355,3991,4364,8343,12,45,221.03,37.8
"2011","Thanet 014","E02005145","Total",6738,3291,3447,6714,24,84,5829.66,1.2
"2011","Thanet 015","E02005146","Total",7789,3814,3975,7510,279,70,114.49,68.0
"2011","Thanet 016","E02005147","Total",8516,4226,4290,8443,73,67,128.53,66.3
"2011","Thanet 017","E02005148","Total",7564,3649,3915,7508,56,83,449.93,16.8
"2011","Tonbridge and Malling 001","E02005149","Total",10405,5122,5283,10252,153,139,2536.94,4.1
"2011","Tonbridge and Malling 002","E02005150","Total",10211,4941,5270,10122,89,64,880.11,11.6
"2011","Tonbridge and Malling 003","E02005151","Total",12594,6184,6410,12557,37,131,459.04,27.4
"2011","Tonbridge and Malling 005","E02005153","Total",8551,4104,4447,8483,68,94,949.39,9.0
"2011","Tonbridge and Malling 006","E02005154","Total",10943,5355,5588,10835,108,253,5084.83,2.2
"2011","Tonbridge and Malling 007","E02005155","Total",10957,5456,5501,10915,42,167,2472.33,4.4
"2011","Tonbridge and Malling 008","E02005156","Total",7289,3590,3699,7154,135,173,3207.34,2.3
"2011","Tonbridge and Malling 009","E02005157","Total",6578,3141,3437,6555,23,63,246.77,26.7
"2011","Tonbridge and Malling 010","E02005158","Total",6567,3228,3339,6477,90,159,1799.73,3.6
"2011","Tonbridge and Malling 011","E02005159","Total",7774,3703,4071,7766,8,160,494.16,15.7
"2011","Tonbridge and Malling 012","E02005160","Total",10525,5412,5113,9985,540,221,550.96,19.1
"2011","Tonbridge and Malling 013","E02005161","Total",8204,4038,4166,8193,11,133,509.24,16.1
"2011","Tonbridge and Malling 014","E02006833","Total",10207,4933,5274,10107,100,166,4822.72,2.1
"2011","Tunbridge Wells 001","E02005162","Total",10720,5283,5437,10670,50,154,3098.27,3.5
"2011","Tunbridge Wells 002","E02005163","Total",8200,4062,4138,8174,26,163,663.92,12.4
"2011","Tunbridge Wells 003","E02005164","Total",7845,3799,4046,7752,93,112,482.09,16.3
"2011","Tunbridge Wells 004","E02005165","Total",7810,3829,3981,7606,204,191,2472.04,3.2
"2011","Tunbridge Wells 005","E02005166","Total",7039,3458,3581,6986,53,61,181.92,38.7
"2011","Tunbridge Wells 006","E02005167","Total",7799,3774,4025,7657,142,220,2469.56,3.2
"2011","Tunbridge Wells 007","E02005168","Total",7533,3676,3857,7414,119,231,198.40,38.0
"2011","Tunbridge Wells 008","E02005169","Total",8862,4677,4185,8779,83,118,137.19,64.6
"2011","Tunbridge Wells 009","E02005170","Total",9453,4490,4963,9158,295,186,798.06,11.8
"2011","Tunbridge Wells 010","E02005171","Total",6181,3056,3125,6101,80,77,393.16,15.7
"2011","Tunbridge Wells 011","E02005172","Total",8649,4389,4260,8372,277,242,9217.70,0.9
"2011","Tunbridge Wells 012","E02005173","Total",8590,4217,4373,8477,113,236,272.19,31.6
"2011","Tunbridge Wells 013","E02005174","Total",7605,3665,3940,7290,315,249,5616.07,1.4
"2011","Tunbridge Wells 014","E02005175","Total",8763,4119,4644,8186,577,271,7132.25,1.2
"2011","Cherwell 001","E02005921","Total",5334,2631,2703,5234,100,139,8301.09,0.6
"2011","Cherwell 002","E02005922","Total",8450,4175,4275,8450,0,88,207.46,40.7
"2011","Cherwell 003","E02005923","Total",5868,2851,3017,5825,43,41,162.22,36.2
"2011","Cherwell 004","E02005924","Total",10880,5364,5516,10725,155,72,754.32,14.4
"2011","Cherwell 005","E02005925","Total",8470,4122,4348,8470,0,67,161.23,52.5
"2011","Cherwell 006","E02005926","Total",7776,3656,4120,7492,284,97,638.41,12.2
"2011","Cherwell 007","E02005927","Total",5409,2650,2759,5363,46,71,182.20,29.7
"2011","Cherwell 008","E02005928","Total",7542,3687,3855,7267,275,198,2321.36,3.2
"2011","Cherwell 009","E02005929","Total",6852,3362,3490,6744,108,216,8742.90,0.8
"2011","Cherwell 010","E02005930","Total",7634,3716,3918,7581,53,163,7980.17,1.0
"2011","Cherwell 011","E02005931","Total",9149,4628,4521,8744,405,168,11881.87,0.8
"2011","Cherwell 012","E02005932","Total",7014,3444,3570,7014,0,68,123.45,56.8
"2011","Cherwell 013","E02005933","Total",7427,3659,3768,7414,13,75,233.73,31.8
"2011","Cherwell 014","E02005934","Total",9155,4485,4670,9155,0,82,204.14,44.8
"2011","Cherwell 015","E02005935","Total",7258,3579,3679,7209,49,62,296.91,24.4
"2011","Cherwell 016","E02005936","Total",9276,5054,4222,8179,1097,207,13898.83,0.7
"2011","Cherwell 017","E02005937","Total",6544,3187,3357,6536,8,95,322.38,20.3
"2011","Cherwell 018","E02005938","Total",5598,2720,2878,5554,44,72,191.96,29.2
"2011","Cherwell 019","E02005939","Total",6232,3156,3076,5960,272,110,2272.23,2.7
"2011","Oxford 001","E02005940","Total",5866,2809,3057,5847,19,153,387.15,15.2
"2011","Oxford 002","E02005941","Total",7209,3587,3622,6296,913,233,189.25,38.1
"2011","Oxford 003","E02005942","Total",6750,3278,3472,5519,1231,289,207.40,32.5
"2011","Oxford 004","E02005943","Total",6259,2977,3282,6222,37,113,366.44,17.1
"2011","Oxford 005","E02005944","Total",7013,3339,3674,6956,57,72,159.68,43.9
"2011","Oxford 006","E02005945","Total",10495,4909,5586,8883,1612,211,286.31,36.7
"2011","Oxford 007","E02005946","Total",7990,3849,4141,7969,21,93,161.91,49.3
"2011","Oxford 008","E02005947","Total",16342,9030,7312,5112,11230,341,353.03,46.3
"2011","Oxford 009","E02005948","Total",6820,3547,3273,6150,670,75,618.53,11.0
"2011","Oxford 010","E02005949","Total",7303,3473,3830,6161,1142,112,162.19,45.0
"2011","Oxford 011","E02005950","Total",11282,5618,5664,10596,686,175,164.68,68.5
"2011","Oxford 012","E02005951","Total",5944,2992,2952,5912,32,86,234.60,25.3
"2011","Oxford 013","E02005952","Total",14349,7190,7159,13772,577,129,460.35,31.2
"2011","Oxford 014","E02005953","Total",5713,2843,2870,5649,64,80,112.71,50.7
"2011","Oxford 015","E02005954","Total",9640,4800,4840,9530,110,108,230.26,41.9
"2011","Oxford 016","E02005955","Total",9863,4874,4989,9700,163,70,242.10,40.7
"2011","Oxford 017","E02005956","Total",6131,2970,3161,6085,46,28,122.50,50.0
"2011","Oxford 018","E02005957","Total",6937,3250,3687,6882,55,25,100.49,69.0
"2011","South Oxfordshire 001","E02005958","Total",5675,2765,2910,5675,0,136,310.46,18.3
"2011","South Oxfordshire 002","E02005959","Total",5556,2765,2791,5428,128,150,5844.77,1.0
"2011","South Oxfordshire 003","E02005960","Total",5886,2828,3058,5836,50,125,957.28,6.1
"2011","South Oxfordshire 004","E02005961","Total",6640,3229,3411,6593,47,160,5603.01,1.2
"2011","South Oxfordshire 005","E02005962","Total",8294,4054,4240,8264,30,165,5223.30,1.6
"2011","South Oxfordshire 006","E02005963","Total",8166,4019,4147,8013,153,119,7186.76,1.1
"2011","South Oxfordshire 007","E02005964","Total",7261,3609,3652,7255,6,150,4778.75,1.5
"2011","South Oxfordshire 008","E02005965","Total",5451,2598,2853,5402,49,155,9872.81,0.6
"2011","South Oxfordshire 009","E02005966","Total",8043,3996,4047,8039,4,95,370.29,21.7
"2011","South Oxfordshire 010","E02005967","Total",5731,2819,2912,5585,146,69,244.95,23.4
"2011","South Oxfordshire 011","E02005968","Total",7670,4161,3509,6559,1111,145,6237.12,1.2
"2011","South Oxfordshire 012","E02005969","Total",9141,4367,4774,9021,120,174,1364.44,6.7
"2011","South Oxfordshire 013","E02005970","Total",5635,2878,2757,5635,0,51,105.09,53.6
"2011","South Oxfordshire 014","E02005971","Total",5731,2788,2943,5727,4,67,137.69,41.6
"2011","South Oxfordshire 015","E02005972","Total",7982,3942,4040,7896,86,219,5586.16,1.4
"2011","South Oxfordshire 016","E02005973","Total",5550,2531,3019,5501,49,90,338.67,16.4
"2011","South Oxfordshire 017","E02005974","Total",6069,2883,3186,6018,51,147,219.05,27.7
"2011","South Oxfordshire 018","E02005975","Total",7910,3930,3980,7564,346,272,4769.32,1.7
"2011","South Oxfordshire 019","E02005976","Total",6130,3066,3064,5795,335,262,6098.56,1.0
"2011","South Oxfordshire 020","E02005977","Total",5736,2777,2959,5677,59,142,2604.89,2.2
"2011","Vale of White Horse 001","E02005978","Total",6670,3245,3425,6592,78,187,3033.39,2.2
"2011","Vale of White Horse 002","E02005979","Total",9140,4512,4628,8845,295,196,1862.29,4.9
"2011","Vale of White Horse 003","E02005980","Total",11518,6334,5184,9902,1616,302,4309.32,2.7
"2011","Vale of White Horse 004","E02005981","Total",8985,4466,4519,8984,1,197,165.26,54.4
"2011","Vale of White Horse 005","E02005982","Total",5849,2925,2924,5843,6,121,139.02,42.1
"2011","Vale of White Horse 006","E02005983","Total",10740,5154,5586,10448,292,153,353.48,30.4
"2011","Vale of White Horse 007","E02005984","Total",6881,3398,3483,6871,10,246,10861.30,0.6
"2011","Vale of White Horse 008","E02005985","Total",7556,3643,3913,7556,0,85,252.21,30.0
"2011","Vale of White Horse 009","E02005986","Total",8991,4417,4574,8918,73,155,3707.29,2.4
"2011","Vale of White Horse 010","E02005987","Total",7640,3719,3921,7596,44,180,3735.66,2.0
"2011","Vale of White Horse 011","E02005988","Total",7178,3642,3536,7178,0,104,997.43,7.2
"2011","Vale of White Horse 014","E02005991","Total",9803,4783,5020,9657,146,152,371.52,26.4
"2011","Vale of White Horse 015","E02005992","Total",9014,4321,4693,8918,96,243,9415.51,1.0
"2011","Vale of White Horse 016","E02006886","Total",11023,5499,5524,10736,287,408,18558.09,0.6
"2011","West Oxfordshire 001","E02005993","Total",6337,3056,3281,6283,54,81,962.35,6.6
"2011","West Oxfordshire 002","E02005994","Total",6078,2945,3133,5801,277,162,13480.30,0.5
"2011","West Oxfordshire 003","E02005995","Total",5907,2850,3057,5850,57,168,12036.36,0.5
"2011","West Oxfordshire 004","E02005996","Total",8027,3826,4201,7973,54,167,7279.53,1.1
"2011","West Oxfordshire 005","E02005997","Total",5555,2713,2842,5537,18,154,3494.72,1.6
"2011","West Oxfordshire 006","E02005998","Total",5816,2815,3001,5716,100,130,2459.12,2.4
"2011","West Oxfordshire 007","E02005999","Total",6169,3047,3122,6110,59,125,5870.71,1.1
"2011","West Oxfordshire 008","E02006000","Total",11829,5707,6122,11686,143,205,348.51,33.9
"2011","West Oxfordshire 009","E02006001","Total",5613,2769,2844,5613,0,97,243.79,23.0
"2011","West Oxfordshire 010","E02006002","Total",10080,4864,5216,10004,76,126,330.02,30.5
"2011","West Oxfordshire 011","E02006003","Total",5416,2650,2766,5395,21,119,4595.67,1.2
"2011","West Oxfordshire 012","E02006004","Total",5574,2746,2828,5436,138,168,12758.83,0.4
"2011","West Oxfordshire 013","E02006005","Total",9100,4463,4637,9020,80,131,223.20,40.8
"2011","West Oxfordshire 014","E02006006","Total",6669,3728,2941,5495,1174,91,248.94,26.8
"2011","West Oxfordshire 015","E02006007","Total",6609,3268,3341,6496,113,147,7107.88,0.9
"2011","Elmbridge 001","E02006317","Total",6008,2860,3148,6007,1,87,163.95,36.6
"2011","Elmbridge 002","E02006318","Total",6337,3103,3234,6271,66,177,297.97,21.3
"2011","Elmbridge 003","E02006319","Total",6743,3241,3502,6708,35,60,125.47,53.7
"2011","Elmbridge 004","E02006320","Total",6511,3219,3292,6511,0,69,454.70,14.3
"2011","Elmbridge 005","E02006321","Total",6307,3030,3277,6182,125,159,188.10,33.5
"2011","Elmbridge 006","E02006322","Total",6343,3093,3250,6313,30,139,214.27,29.6
"2011","Elmbridge 007","E02006323","Total",6790,3296,3494,6790,0,133,189.80,35.8
"2011","Elmbridge 008","E02006324","Total",7430,3551,3879,7339,91,118,209.82,35.4
"2011","Elmbridge 009","E02006325","Total",8944,4420,4524,8915,29,252,470.75,19.0
"2011","Elmbridge 010","E02006326","Total",6530,3156,3374,6461,69,137,202.76,32.2
"2011","Elmbridge 011","E02006327","Total",6352,3086,3266,6305,47,140,207.44,30.6
"2011","Elmbridge 012","E02006328","Total",8947,4400,4547,8867,80,136,434.67,20.6
"2011","Elmbridge 013","E02006329","Total",6743,3266,3477,6698,45,254,930.00,7.3
"2011","Elmbridge 014","E02006330","Total",9290,4435,4855,9178,112,143,937.71,9.9
"2011","Elmbridge 015","E02006331","Total",7168,3461,3707,7094,74,205,471.15,15.2
"2011","Elmbridge 016","E02006332","Total",6502,3149,3353,6291,211,200,938.19,6.9
"2011","Elmbridge 017","E02006333","Total",9489,4597,4892,9223,266,297,1560.20,6.1
"2011","Elmbridge 018","E02006334","Total",8441,4099,4342,8330,111,362,1509.12,5.6
"2011","Epsom and Ewell 001","E02006335","Total",7834,3847,3987,7831,3,143,184.37,42.5
"2011","Epsom and Ewell 002","E02006336","Total",6797,3258,3539,6793,4,82,133.12,51.1
"2011","Epsom and Ewell 003","E02006337","Total",8741,4288,4453,8741,0,154,192.72,45.4
"2011","Epsom and Ewell 004","E02006338","Total",6806,3330,3476,6791,15,85,143.73,47.4
"2011","Epsom and Ewell 005","E02006339","Total",8969,4440,4529,8783,186,102,505.78,17.7
"2011","Epsom and Ewell 007","E02006341","Total",9505,4581,4924,9498,7,159,232.58,40.9
"2011","Epsom and Ewell 008","E02006342","Total",7216,3387,3829,6948,268,105,181.23,39.8
"2011","Epsom and Ewell 009","E02006343","Total",8686,4171,4515,8238,448,189,1059.64,8.2
"2011","Epsom and Ewell 010","E02006837","Total",10548,5110,5438,10403,145,259,774.12,13.6
"2011","Guildford 001","E02006344","Total",8500,4067,4433,8151,349,198,4827.37,1.8
"2011","Guildford 002","E02006345","Total",6672,3508,3164,6159,513,122,3538.82,1.9
"2011","Guildford 003","E02006346","Total",9829,4704,5125,9684,145,395,3022.00,3.3
"2011","Guildford 004","E02006347","Total",7180,3554,3626,7126,54,66,523.85,13.7
"2011","Guildford 005","E02006348","Total",8529,4177,4352,8449,80,141,1794.02,4.8
"2011","Guildford 006","E02006349","Total",8161,4130,4031,7798,363,111,119.90,68.1
"2011","Guildford 007","E02006350","Total",6187,3155,3032,6179,8,44,282.66,21.9
"2011","Guildford 008","E02006351","Total",8267,4006,4261,8239,28,190,286.58,28.8
"2011","Guildford 009","E02006352","Total",6087,3120,2967,6077,10,99,107.96,56.4
"2011","Guildford 010","E02006353","Total",6144,3051,3093,6127,17,39,206.18,29.8
"2011","Guildford 011","E02006354","Total",8976,4347,4629,8871,105,266,542.90,16.5
"2011","Guildford 012","E02006355","Total",7807,3849,3958,6292,1515,76,266.59,29.3
"2011","Guildford 013","E02006356","Total",10467,5522,4945,10352,115,172,275.32,38.0
"2011","Guildford 014","E02006357","Total",6156,2975,3181,6133,23,57,572.69,10.7
"2011","Guildford 015","E02006358","Total",8525,4256,4269,6187,2338,183,248.19,34.3
"2011","Guildford 016","E02006359","Total",5930,2940,2990,5858,72,215,836.16,7.1
"2011","Guildford 017","E02006360","Total",8268,3877,4391,7787,481,224,5219.35,1.6
"2011","Guildford 018","E02006361","Total",5498,2685,2813,5451,47,151,4422.72,1.2
"2011","Mole Valley 001","E02006362","Total",6654,3202,3452,6600,54,182,560.01,11.9
"2011","Mole Valley 002","E02006363","Total",5887,2843,3044,5741,146,144,500.12,11.8
"2011","Mole Valley 003","E02006364","Total",7035,3565,3470,6976,59,62,616.97,11.4
"2011","Mole Valley 004","E02006365","Total",5909,2858,3051,5679,230,180,735.39,8.0
"2011","Mole Valley 005","E02006366","Total",7996,3967,4029,7909,87,227,971.68,8.2
"2011","Mole Valley 006","E02006367","Total",5779,2739,3040,5741,38,149,433.71,13.3
"2011","Mole Valley 007","E02006368","Total",5596,2676,2920,5572,24,134,672.86,8.3
"2011","Mole Valley 008","E02006369","Total",6489,3202,3287,6398,91,146,3260.56,2.0
"2011","Mole Valley 009","E02006370","Total",6152,2978,3174,5956,196,155,1373.01,4.5
"2011","Mole Valley 010","E02006371","Total",7001,3384,3617,6800,201,184,401.62,17.4
"2011","Mole Valley 011","E02006372","Total",6417,3144,3273,6349,68,100,1325.14,4.8
"2011","Mole Valley 012","E02006373","Total",7561,3742,3819,7467,94,215,9479.99,0.8
"2011","Mole Valley 013","E02006374","Total",6899,3449,3450,6797,102,146,5501.20,1.3
"2011","Reigate and Banstead 001","E02006375","Total",6242,3058,3184,6189,53,150,293.58,21.3
"2011","Reigate and Banstead 002","E02006376","Total",9110,4404,4706,7829,1281,149,462.49,19.7
"2011","Reigate and Banstead 003","E02006377","Total",5804,2821,2983,5782,22,115,234.35,24.8
"2011","Reigate and Banstead 004","E02006378","Total",8823,4354,4469,8681,142,184,1824.96,4.8
"2011","Reigate and Banstead 005","E02006379","Total",5830,2783,3047,5830,0,49,143.92,40.5
"2011","Reigate and Banstead 006","E02006380","Total",7123,3471,3652,6906,217,182,1395.97,5.1
"2011","Reigate and Banstead 007","E02006381","Total",6891,3349,3542,6751,140,155,1409.40,4.9
"2011","Reigate and Banstead 008","E02006382","Total",6528,3175,3353,6404,124,59,235.89,27.7
"2011","Reigate and Banstead 009","E02006383","Total",9433,4573,4860,8716,717,229,1831.77,5.1
"2011","Reigate and Banstead 010","E02006384","Total",10053,4951,5102,9943,110,128,207.88,48.4
"2011","Reigate and Banstead 011","E02006385","Total",9978,5005,4973,9823,155,128,389.48,25.6
"2011","Reigate and Banstead 012","E02006386","Total",7859,3805,4054,7760,99,185,321.55,24.4
"2011","Reigate and Banstead 013","E02006387","Total",6427,3084,3343,6427,0,94,219.29,29.3
"2011","Reigate and Banstead 014","E02006388","Total",8857,4330,4527,8728,129,98,657.28,13.5
"2011","Reigate and Banstead 015","E02006389","Total",6801,3343,3458,6737,64,90,2161.62,3.1
"2011","Reigate and Banstead 016","E02006390","Total",7854,3852,4002,7848,6,91,297.12,26.4
"2011","Reigate and Banstead 017","E02006391","Total",5925,2923,3002,5907,18,77,580.81,10.2
"2011","Reigate and Banstead 018","E02006392","Total",8297,4141,4156,8085,212,72,246.05,33.7
"2011","Runnymede 001","E02006393","Total",6384,3009,3375,6384,0,69,263.81,24.2
"2011","Runnymede 002","E02006394","Total",10607,4958,5649,8208,2399,233,921.19,11.5
"2011","Runnymede 003","E02006395","Total",9120,4489,4631,9080,40,110,424.10,21.5
"2011","Runnymede 004","E02006396","Total",5767,2899,2868,5551,216,84,1068.24,5.4
"2011","Runnymede 005","E02006397","Total",5940,2888,3052,5801,139,205,1479.09,4.0
"2011","Runnymede 006","E02006398","Total",7573,3773,3800,7558,15,69,290.32,26.1
"2011","Runnymede 007","E02006399","Total",10652,5184,5468,10547,105,118,653.45,16.3
"2011","Runnymede 008","E02006400","Total",5672,2754,2918,5558,114,91,1834.57,3.1
"2011","Runnymede 009","E02006401","Total",9208,4458,4750,9117,91,119,329.92,27.9
"2011","Runnymede 010","E02006402","Total",9587,4736,4851,9542,45,153,539.63,17.8
"2011","Spelthorne 001","E02006403","Total",6035,3036,2999,6035,0,47,566.42,10.7
"2011","Spelthorne 002","E02006404","Total",6615,3271,3344,6563,52,32,209.32,31.6
"2011","Spelthorne 003","E02006405","Total",10363,5101,5262,10050,313,126,252.23,41.1
"2011","Spelthorne 004","E02006406","Total",7861,3951,3910,7811,50,78,549.77,14.3
"2011","Spelthorne 005","E02006407","Total",8796,4302,4494,8771,25,90,218.03,40.3
"2011","Spelthorne 006","E02006408","Total",8223,4067,4156,8223,0,64,202.97,40.5
"2011","Spelthorne 007","E02006409","Total",6734,3262,3472,6714,20,68,173.05,38.9
"2011","Spelthorne 008","E02006410","Total",8076,4000,4076,7987,89,67,174.46,46.3
"2011","Spelthorne 009","E02006411","Total",7107,3485,3622,7095,12,82,174.65,40.7
"2011","Spelthorne 010","E02006412","Total",6798,3331,3467,6790,8,117,365.96,18.6
"2011","Spelthorne 011","E02006413","Total",6106,2952,3154,5999,107,72,354.45,17.2
"2011","Spelthorne 012","E02006414","Total",6207,3039,3168,6139,68,63,707.25,8.8
"2011","Spelthorne 013","E02006415","Total",6677,3256,3421,6660,17,100,539.88,12.4
"2011","Surrey Heath 001","E02006416","Total",8191,4057,4134,8117,74,241,3267.96,2.5
"2011","Surrey Heath 002","E02006417","Total",5592,2791,2801,5508,84,89,865.13,6.5
"2011","Surrey Heath 003","E02006418","Total",6791,3307,3484,6756,35,147,419.06,16.2
"2011","Surrey Heath 004","E02006419","Total",7927,3861,4066,7902,25,101,452.45,17.5
"2011","Surrey Heath 005","E02006420","Total",7411,3633,3778,7282,129,212,361.00,20.5
"2011","Surrey Heath 006","E02006421","Total",8658,4578,4080,7948,710,186,1818.16,4.8
"2011","Surrey Heath 007","E02006422","Total",6049,2964,3085,6026,23,153,176.69,34.2
"2011","Surrey Heath 008","E02006423","Total",10349,5165,5184,10143,206,145,413.42,25.0
"2011","Surrey Heath 009","E02006424","Total",6180,3064,3116,6159,21,137,272.74,22.7
"2011","Surrey Heath 010","E02006425","Total",6178,3030,3148,6074,104,100,213.79,28.9
"2011","Surrey Heath 011","E02006426","Total",5717,2820,2897,5717,0,111,234.37,24.4
"2011","Surrey Heath 012","E02006427","Total",7101,3598,3503,6808,293,121,1014.51,7.0
"2011","Tandridge 002","E02006429","Total",7217,3587,3630,7209,8,117,502.11,14.4
"2011","Tandridge 003","E02006430","Total",8976,4327,4649,8793,183,132,210.77,42.6
"2011","Tandridge 004","E02006431","Total",10489,5004,5485,9978,511,215,1675.55,6.3
"2011","Tandridge 005","E02006432","Total",5501,2658,2843,5319,182,124,613.82,9.0
"2011","Tandridge 006","E02006433","Total",9417,4515,4902,9226,191,294,3625.20,2.6
"2011","Tandridge 007","E02006434","Total",6129,2981,3148,6006,123,110,841.31,7.3
"2011","Tandridge 008","E02006435","Total",5809,2807,3002,5664,145,110,3713.74,1.6
"2011","Tandridge 009","E02006436","Total",5949,2834,3115,5832,117,76,1806.45,3.3
"2011","Tandridge 010","E02006437","Total",8267,3995,4272,7791,476,152,4562.35,1.8
"2011","Tandridge 011","E02006438","Total",7797,3873,3924,7711,86,132,4124.88,1.9
"2011","Tandridge 012","E02006790","Total",7447,3577,3870,7387,60,128,3142.80,2.4
"2011","Waverley 001","E02006439","Total",5851,2873,2978,5851,0,62,439.06,13.3
"2011","Waverley 002","E02006440","Total",7126,3537,3589,7126,0,122,432.09,16.5
"2011","Waverley 003","E02006441","Total",7617,3566,4051,7161,456,148,938.08,8.1
"2011","Waverley 004","E02006442","Total",5927,2913,3014,5819,108,198,1065.35,5.6
"2011","Waverley 005","E02006443","Total",7271,3477,3794,7210,61,67,240.09,30.3
"2011","Waverley 006","E02006444","Total",6737,3312,3425,6679,58,148,236.99,28.4
"2011","Waverley 007","E02006445","Total",7233,3870,3363,6497,736,186,354.29,20.4
"2011","Waverley 008","E02006446","Total",6771,3155,3616,6561,210,230,3100.41,2.2
"2011","Waverley 009","E02006447","Total",6230,3135,3095,5994,236,147,541.00,11.5
"2011","Waverley 010","E02006448","Total",7300,3571,3729,7146,154,224,374.12,19.5
"2011","Waverley 011","E02006449","Total",6898,3328,3570,6880,18,142,2489.71,2.8
"2011","Waverley 012","E02006450","Total",6979,3424,3555,6488,491,283,7662.50,0.9
"2011","Waverley 013","E02006451","Total",10692,5311,5381,10163,529,259,1769.32,6.0
"2011","Waverley 015","E02006453","Total",8025,3801,4224,7556,469,235,9199.87,0.9
"2011","Waverley 016","E02006454","Total",6553,3120,3433,6521,32,202,994.31,6.6
"2011","Waverley 017","E02006455","Total",5981,2818,3163,5634,347,133,649.80,9.2
"2011","Waverley 018","E02006839","Total",8381,4115,4266,7933,448,263,4029.94,2.1
"2011","Woking 001","E02006456","Total",7724,3737,3987,7662,62,68,285.31,27.1
"2011","Woking 002","E02006457","Total",9124,4399,4725,9019,105,274,534.88,17.1
"2011","Woking 003","E02006458","Total",9204,4506,4698,9009,195,230,1048.09,8.8
"2011","Woking 004","E02006459","Total",10574,5471,5103,10563,11,98,171.30,61.7
"2011","Woking 005","E02006460","Total",9488,4600,4888,9484,4,98,166.09,57.1
"2011","Woking 006","E02006461","Total",6735,3344,3391,6566,169,168,767.08,8.8
"2011","Woking 007","E02006462","Total",8452,4196,4256,8412,40,112,379.56,22.3
"2011","Woking 008","E02006463","Total",9534,4865,4669,9445,89,120,189.11,50.4
"2011","Woking 009","E02006464","Total",6866,3384,3482,6847,19,98,289.15,23.7
"2011","Woking 010","E02006465","Total",6188,2988,3200,6091,97,162,248.15,24.9
"2011","Woking 011","E02006466","Total",8768,4409,4359,8691,77,100,470.56,18.6
"2011","Woking 012","E02006467","Total",6541,3245,3296,6493,48,173,1810.29,3.6
"2011","Adur 001","E02006534","Total",8524,4140,4384,8497,27,62,653.00,13.1
"2011","Adur 002","E02006535","Total",6634,3218,3416,6568,66,98,584.52,11.3
"2011","Adur 003","E02006536","Total",7100,3539,3561,6816,284,90,1059.41,6.7
"2011","Adur 004","E02006537","Total",10127,4809,5318,9988,139,76,295.35,34.3
"2011","Adur 005","E02006538","Total",8526,4136,4390,8464,62,92,199.22,42.8
"2011","Adur 006","E02006539","Total",7089,3459,3630,7038,51,51,829.67,8.5
"2011","Adur 007","E02006540","Total",5665,2728,2937,5654,11,32,391.50,14.5
"2011","Adur 008","E02006541","Total",7517,3484,4033,7399,118,45,168.04,44.7
"2011","Arun 001","E02006542","Total",5741,2772,2969,5608,133,89,7283.25,0.8
"2011","Arun 002","E02006543","Total",5546,2633,2913,5528,18,78,4561.47,1.2
"2011","Arun 003","E02006544","Total",10073,4869,5204,9849,224,161,2478.76,4.1
"2011","Arun 004","E02006545","Total",8259,3992,4267,8240,19,60,496.23,16.6
"2011","Arun 005","E02006546","Total",9631,4544,5087,9526,105,72,631.45,15.3
"2011","Arun 006","E02006547","Total",5926,3033,2893,5462,464,67,1659.46,3.6
"2011","Arun 007","E02006548","Total",9452,4346,5106,9394,58,86,208.75,45.3
"2011","Arun 008","E02006549","Total",5870,2703,3167,5798,72,72,577.78,10.2
"2011","Arun 009","E02006550","Total",9414,4481,4933,9327,87,85,230.03,40.9
"2011","Arun 010","E02006551","Total",7785,3524,4261,7559,226,82,288.86,27.0
"2011","Arun 011","E02006552","Total",7109,3585,3524,6778,331,38,215.51,33.0
"2011","Arun 012","E02006553","Total",7298,3510,3788,7273,25,48,694.52,10.5
"2011","Arun 013","E02006554","Total",6680,3141,3539,6657,23,81,562.31,11.9
"2011","Arun 014","E02006555","Total",7476,3584,3892,7362,114,52,144.76,51.6
"2011","Arun 015","E02006556","Total",8249,3861,4388,8154,95,104,352.71,23.4
"2011","Arun 016","E02006557","Total",7148,3459,3689,7017,131,55,137.24,52.1
"2011","Arun 017","E02006558","Total",10638,5171,5467,9102,1536,58,176.76,60.2
"2011","Arun 018","E02006559","Total",8124,3796,4328,8031,93,97,300.17,27.1
"2011","Arun 019","E02006560","Total",9099,4299,4800,9079,20,56,1070.80,8.5
"2011","Chichester 001","E02006561","Total",6740,3333,3407,6480,260,210,6699.04,1.0
"2011","Chichester 002","E02006562","Total",5855,2867,2988,5855,0,201,7691.26,0.8
"2011","Chichester 003","E02006563","Total",5621,2763,2858,5549,72,261,12869.14,0.4
"2011","Chichester 004","E02006564","Total",7238,3373,3865,7145,93,126,3194.52,2.3
"2011","Chichester 005","E02006565","Total",8077,3818,4259,7799,278,260,15112.99,0.5
"2011","Chichester 006","E02006566","Total",7639,3605,4034,7499,140,171,10927.39,0.7
"2011","Chichester 007","E02006567","Total",7446,3579,3867,7404,42,154,8243.87,0.9
"2011","Chichester 008","E02006568","Total",10705,4989,5716,10336,369,110,332.78,32.2
"2011","Chichester 009","E02006569","Total",7818,3919,3899,7203,615,160,2624.38,3.0
"2011","Chichester 010","E02006570","Total",8374,3963,4411,8065,309,114,236.42,35.4
"2011","Chichester 011","E02006571","Total",7652,3639,4013,7519,133,160,1715.40,4.5
"2011","Chichester 012","E02006572","Total",9132,4365,4767,8984,148,127,3467.48,2.6
"2011","Chichester 013","E02006573","Total",10760,5138,5622,10538,222,207,4541.93,2.4
"2011","Chichester 014","E02006574","Total",10737,5050,5687,10461,276,77,966.48,11.1
"2011","Crawley 001","E02006575","Total",8255,4235,4020,8119,136,60,1167.45,7.1
"2011","Crawley 002","E02006576","Total",7958,3981,3977,7946,12,145,699.79,11.4
"2011","Crawley 003","E02006577","Total",7922,3827,4095,7766,156,57,196.17,40.4
"2011","Crawley 004","E02006578","Total",9673,4950,4723,9610,63,57,538.50,18.0
"2011","Crawley 005","E02006579","Total",7877,3926,3951,7864,13,69,237.90,33.1
"2011","Crawley 006","E02006580","Total",8007,3897,4110,7935,72,85,210.40,38.1
"2011","Crawley 007","E02006581","Total",8589,4207,4382,8380,209,75,187.53,45.8
"2011","Crawley 008","E02006582","Total",7943,3960,3983,7932,11,123,196.26,40.5
"2011","Crawley 009","E02006583","Total",8945,4427,4518,8879,66,97,313.64,28.5
"2011","Crawley 010","E02006584","Total",7442,3670,3772,7442,0,76,132.87,56.0
"2011","Crawley 011","E02006585","Total",7770,3729,4041,7770,0,64,308.92,25.2
"2011","Crawley 012","E02006586","Total",7836,3866,3970,7836,0,85,122.20,64.1
"2011","Crawley 013","E02006587","Total",8380,4023,4357,8380,0,60,185.44,45.2
"2011","Horsham 001","E02006588","Total",7481,3718,3763,7322,159,115,4982.92,1.5
"2011","Horsham 002","E02006589","Total",11206,5422,5784,11206,0,208,819.02,13.7
"2011","Horsham 003","E02006590","Total",8598,4158,4440,8474,124,144,2214.16,3.9
"2011","Horsham 004","E02006591","Total",7986,3886,4100,7902,84,113,187.81,42.5
"2011","Horsham 005","E02006592","Total",6342,3093,3249,5925,417,191,5254.41,1.2
"2011","Horsham 006","E02006593","Total",10460,5039,5421,10213,247,136,290.88,36.0
"2011","Horsham 007","E02006594","Total",6701,3294,3407,6701,0,137,387.94,17.3
"2011","Horsham 008","E02006595","Total",8519,4102,4417,7662,857,264,4969.20,1.7
"2011","Horsham 009","E02006596","Total",8692,4369,4323,8692,0,161,384.09,22.6
"2011","Horsham 010","E02006597","Total",9379,4618,4761,9313,66,188,6344.73,1.5
"2011","Horsham 011","E02006598","Total",5500,2737,2763,5398,102,121,5280.33,1.0
"2011","Horsham 012","E02006599","Total",6984,3409,3575,6975,9,209,3785.61,1.8
"2011","Horsham 013","E02006600","Total",9278,4398,4880,9201,77,139,4820.52,1.9
"2011","Horsham 014","E02006601","Total",8133,3806,4327,7933,200,146,4737.03,1.7
"2011","Horsham 015","E02006602","Total",7466,3696,3770,7225,241,148,5565.33,1.3
"2011","Horsham 016","E02006603","Total",8576,4061,4515,8491,85,159,3003.09,2.9
"2011","Mid Sussex 001","E02006604","Total",12480,6052,6428,12302,178,190,307.30,40.6
"2011","Mid Sussex 002","E02006605","Total",6527,3346,3181,6109,418,120,2268.15,2.9
"2011","Mid Sussex 003","E02006606","Total",8188,4075,4113,8069,119,157,785.57,10.4
"2011","Mid Sussex 004","E02006607","Total",7548,3730,3818,7436,112,175,1601.94,4.7
"2011","Mid Sussex 005","E02006608","Total",5770,2838,2932,5749,21,117,1117.01,5.2
"2011","Mid Sussex 006","E02006609","Total",7178,3621,3557,6777,401,206,7124.78,1.0
"2011","Mid Sussex 007","E02006610","Total",7087,3510,3577,6851,236,178,7434.39,1.0
"2011","Mid Sussex 008","E02006611","Total",10153,4877,5276,10026,127,209,522.62,19.4
"2011","Mid Sussex 009","E02006612","Total",10153,5016,5137,9888,265,121,317.26,32.0
"2011","Mid Sussex 010","E02006613","Total",7218,3441,3777,7218,0,75,165.33,43.7
"2011","Mid Sussex 011","E02006614","Total",10030,4893,5137,9990,40,232,2430.01,4.1
"2011","Mid Sussex 012","E02006615","Total",6773,3294,3479,6714,59,86,149.04,45.4
"2011","Mid Sussex 013","E02006616","Total",8066,3946,4120,8051,15,87,266.02,30.3
"2011","Mid Sussex 014","E02006617","Total",9083,4436,4647,8989,94,86,236.15,38.5
"2011","Mid Sussex 015","E02006618","Total",6187,3010,3177,5996,191,118,295.62,20.9
"2011","Mid Sussex 016","E02006619","Total",8226,4040,4186,7982,244,163,7176.85,1.1
"2011","Mid Sussex 017","E02006620","Total",9193,4337,4856,9144,49,147,1204.35,7.6
"2011","Worthing 001","E02006621","Total",7581,3648,3933,7488,93,96,540.91,14.0
"2011","Worthing 002","E02006622","Total",7711,3767,3944,7648,63,93,168.13,45.9
"2011","Worthing 003","E02006623","Total",7887,3748,4139,7836,51,44,143.58,54.9
"2011","Worthing 004","E02006624","Total",7152,3506,3646,7135,17,141,597.15,12.0
"2011","Worthing 005","E02006625","Total",8015,3895,4120,8002,13,68,166.32,48.2
"2011","Worthing 006","E02006626","Total",7409,3571,3838,7403,6,55,409.63,18.1
"2011","Worthing 007","E02006627","Total",8495,4107,4388,8404,91,87,200.51,42.4
"2011","Worthing 008","E02006628","Total",9008,4336,4672,8936,72,76,111.58,80.7
"2011","Worthing 009","E02006629","Total",7930,3806,4124,7735,195,60,184.99,42.9
"2011","Worthing 010","E02006630","Total",8147,3860,4287,7405,742,78,107.92,75.5
"2011","Worthing 011","E02006631","Total",9316,4644,4672,8939,377,76,147.23,63.3
"2011","Worthing 012","E02006632","Total",7999,3783,4216,7878,121,98,154.61,51.7
"2011","Worthing 013","E02006633","Total",7990,3713,4277,7943,47,91,315.65,25.3
"2011","Bath and North East Somerset 001","E02002985","Total",5213,2506,2707,5147,66,63,529.15,9.9
"2011","Bath and North East Somerset 002","E02002986","Total",5024,2322,2702,4972,52,31,199.36,25.2
"2011","Bath and North East Somerset 003","E02002987","Total",5404,2645,2759,5371,33,94,485.77,11.1
"2011","Bath and North East Somerset 004","E02002988","Total",5469,2628,2841,5413,56,90,174.15,31.4
"2011","Bath and North East Somerset 005","E02002989","Total",5324,2541,2783,5281,43,102,197.37,27.0
"2011","Bath and North East Somerset 006","E02002990","Total",5920,3023,2897,5887,33,83,86.95,68.1
"2011","Bath and North East Somerset 007","E02002991","Total",10259,5111,5148,9794,465,194,375.58,27.3
"2011","Bath and North East Somerset 008","E02002992","Total",5938,2796,3142,5831,107,128,186.39,31.9
"2011","Bath and North East Somerset 009","E02002993","Total",5516,2772,2744,5269,247,98,129.64,42.5
"2011","Bath and North East Somerset 010","E02002994","Total",10199,4956,5243,9914,285,278,8272.80,1.2
"2011","Bath and North East Somerset 011","E02002995","Total",5315,2574,2741,5193,122,30,154.50,34.4
"2011","Bath and North East Somerset 012","E02002996","Total",10633,5278,5355,7941,2692,249,628.65,16.9
"2011","Bath and North East Somerset 013","E02002997","Total",6469,3131,3338,5823,646,74,93.73,69.0
"2011","Bath and North East Somerset 014","E02002998","Total",5882,2924,2958,5819,63,83,96.19,61.1
"2011","Bath and North East Somerset 015","E02002999","Total",5529,2699,2830,5529,0,59,134.89,41.0
"2011","Bath and North East Somerset 016","E02003000","Total",9202,4524,4678,9042,160,178,4657.86,2.0
"2011","Bath and North East Somerset 017","E02003001","Total",5505,2703,2802,5410,95,174,206.37,26.7
"2011","Bath and North East Somerset 018","E02003002","Total",5419,2582,2837,5380,39,104,273.19,19.8
"2011","Bath and North East Somerset 019","E02003003","Total",5681,2773,2908,5681,0,51,129.93,43.7
"2011","Bath and North East Somerset 020","E02003004","Total",6302,3084,3218,6173,129,92,3506.79,1.8
"2011","Bath and North East Somerset 021","E02003005","Total",6154,3006,3148,6152,2,191,7150.05,0.9
"2011","Bath and North East Somerset 022","E02003006","Total",8881,4351,4530,8474,407,139,4042.93,2.2
"2011","Bath and North East Somerset 023","E02003007","Total",8307,4073,4234,8140,167,94,1493.30,5.6
"2011","Bath and North East Somerset 024","E02003008","Total",5620,2760,2860,5607,13,57,612.10,9.2
"2011","Bath and North East Somerset 025","E02003009","Total",5875,2886,2989,5857,18,85,307.36,19.1
"2011","Bath and North East Somerset 026","E02003010","Total",5854,2895,2959,5807,47,53,238.62,24.5
"2011","Bath and North East Somerset 027","E02003011","Total",5122,2529,2593,5070,52,63,210.46,24.3
"2011","Bournemouth 001","E02003172","Total",6227,3076,3151,6225,2,56,256.72,24.3
"2011","Bournemouth 002","E02003173","Total",6608,3169,3439,6595,13,17,231.90,28.5
"2011","Bournemouth 003","E02003174","Total",8096,3892,4204,8021,75,65,221.26,36.6
"2011","Bournemouth 004","E02003175","Total",8982,4278,4704,8925,57,82,314.97,28.5
"2011","Bournemouth 005","E02003176","Total",7019,3363,3656,7012,7,50,215.97,32.5
"2011","Bournemouth 006","E02003177","Total",7977,3912,4065,7971,6,99,143.01,55.8
"2011","Bournemouth 007","E02003178","Total",8342,4094,4248,8292,50,60,200.84,41.5
"2011","Bournemouth 008","E02003179","Total",6469,3098,3371,6425,44,50,264.85,24.4
"2011","Bournemouth 009","E02003180","Total",9481,4637,4844,9410,71,95,119.80,79.1
"2011","Bournemouth 010","E02003181","Total",8496,4171,4325,8380,116,138,177.02,48.0
"2011","Bournemouth 011","E02003182","Total",6561,3180,3381,6503,58,111,317.16,20.7
"2011","Bournemouth 012","E02003183","Total",7069,3427,3642,6869,200,153,289.94,24.4
"2011","Bournemouth 013","E02003184","Total",7911,4119,3792,7751,160,88,121.69,65.0
"2011","Bournemouth 014","E02003185","Total",7524,3664,3860,7498,26,77,145.85,51.6
"2011","Bournemouth 015","E02003186","Total",8799,4558,4241,8795,4,103,163.61,53.8
"2011","Bournemouth 016","E02003187","Total",9110,4586,4524,8962,148,87,154.92,58.8
"2011","Bournemouth 017","E02003188","Total",9950,5232,4718,9183,767,63,187.64,53.0
"2011","Bournemouth 018","E02003189","Total",8372,4041,4331,7918,454,93,144.28,58.0
"2011","Bournemouth 019","E02003190","Total",9843,5348,4495,9406,437,36,99.08,99.3
"2011","Bournemouth 020","E02003191","Total",7995,3763,4232,7862,133,100,405.77,19.7
"2011","Bournemouth 021","E02003192","Total",10184,5477,4707,9154,1030,88,189.50,53.7
"2011","Bournemouth 023","E02006883","Total",5469,2717,2752,5299,170,29,88.43,61.8
"2011","Bournemouth 024","E02006885","Total",7007,3584,3423,6682,325,45,163.67,42.8
"2011","Bristol 001","E02003012","Total",10699,5035,5664,10582,117,64,347.04,30.8
"2011","Bristol 002","E02003013","Total",11956,5777,6179,11824,132,66,277.03,43.2
"2011","Bristol 003","E02003014","Total",7755,3724,4031,7715,40,41,1086.09,7.1
"2011","Bristol 004","E02003015","Total",5801,2823,2978,5737,64,51,154.18,37.6
"2011","Bristol 005","E02003016","Total",7529,3796,3733,7481,48,53,107.59,70.0
"2011","Bristol 006","E02003017","Total",6042,2854,3188,5877,165,97,138.17,43.7
"2011","Bristol 007","E02003018","Total",5728,2769,2959,5728,0,67,273.92,20.9
"2011","Bristol 008","E02003019","Total",9339,4550,4789,9261,78,58,740.64,12.6
"2011","Bristol 009","E02003020","Total",6233,2870,3363,5892,341,148,253.08,24.6
"2011","Bristol 010","E02003021","Total",6771,3518,3253,6737,34,48,107.83,62.8
"2011","Bristol 011","E02003022","Total",5867,2807,3060,5856,11,138,127.70,45.9
"2011","Bristol 012","E02003023","Total",5971,2909,3062,5880,91,84,255.35,23.4
"2011","Bristol 013","E02003024","Total",8759,4223,4536,8061,698,65,173.15,50.6
"2011","Bristol 014","E02003025","Total",6766,3408,3358,6701,65,36,321.00,21.1
"2011","Bristol 015","E02003026","Total",9269,4521,4748,7261,2008,270,452.87,20.5
"2011","Bristol 016","E02003027","Total",11911,6032,5879,11554,357,184,152.65,78.0
"2011","Bristol 017","E02003028","Total",8524,4308,4216,8312,212,193,126.55,67.4
"2011","Bristol 018","E02003029","Total",6222,2981,3241,6203,19,34,101.56,61.3
"2011","Bristol 019","E02003030","Total",7176,3624,3552,7122,54,73,173.38,41.4
"2011","Bristol 020","E02003031","Total",10253,5297,4956,10083,170,222,122.40,83.8
"2011","Bristol 021","E02003032","Total",7282,3592,3690,7200,82,43,169.80,42.9
"2011","Bristol 022","E02003033","Total",8999,4663,4336,8896,103,146,78.57,114.5
"2011","Bristol 023","E02003034","Total",12263,6343,5920,12190,73,84,126.46,97.0
"2011","Bristol 025","E02003036","Total",8557,4536,4021,7934,623,118,79.35,107.8
"2011","Bristol 026","E02003037","Total",8734,4523,4211,8654,80,125,82.79,105.5
"2011","Bristol 027","E02003038","Total",6359,3132,3227,6331,28,32,93.66,67.9
"2011","Bristol 028","E02003039","Total",8045,3903,4142,7936,109,38,115.68,69.5
"2011","Bristol 029","E02003040","Total",9125,4635,4490,9023,102,39,132.79,68.7
"2011","Bristol 030","E02003041","Total",6194,3248,2946,5853,341,100,112.52,55.0
"2011","Bristol 032","E02003043","Total",10938,5835,5103,10166,772,111,247.56,44.2
"2011","Bristol 033","E02003044","Total",5798,2871,2927,5784,14,33,136.95,42.3
"2011","Bristol 034","E02003045","Total",6890,3635,3255,6099,791,85,63.35,108.8
"2011","Bristol 035","E02003046","Total",9214,4524,4690,9200,14,47,179.45,51.3
"2011","Bristol 036","E02003047","Total",10037,5080,4957,9852,185,80,190.43,52.7
"2011","Bristol 037","E02003048","Total",6516,3335,3181,6497,19,63,88.98,73.2
"2011","Bristol 038","E02003049","Total",7272,3639,3633,7163,109,56,312.70,23.3
"2011","Bristol 039","E02003050","Total",8452,4344,4108,8360,92,35,147.43,57.3
"2011","Bristol 040","E02003051","Total",6664,3279,3385,6664,0,46,96.27,69.2
"2011","Bristol 041","E02003052","Total",6502,3122,3380,6497,5,31,174.64,37.2
"2011","Bristol 042","E02003053","Total",8066,4018,4048,8012,54,69,144.05,56.0
"2011","Bristol 043","E02003054","Total",6453,3248,3205,6391,62,39,245.08,26.3
"2011","Bristol 044","E02003055","Total",8300,3923,4377,8300,0,48,141.71,58.6
"2011","Bristol 045","E02003056","Total",7216,3429,3787,7202,14,50,181.43,39.8
"2011","Bristol 046","E02003057","Total",5822,2850,2972,5771,51,38,238.64,24.4
"2011","Bristol 047","E02003058","Total",8987,4319,4668,8873,114,34,265.15,33.9
"2011","Bristol 048","E02003059","Total",5638,2696,2942,5638,0,24,163.59,34.5
"2011","Bristol 049","E02003060","Total",10802,5194,5608,10661,141,84,304.83,35.4
"2011","Bristol 050","E02003061","Total",5754,2647,3107,5747,7,16,117.66,48.9
"2011","Bristol 051","E02003062","Total",5836,2808,3028,5768,68,14,127.34,45.8
"2011","Bristol 052","E02003063","Total",7040,3520,3520,7036,4,31,170.51,41.3
"2011","Bristol 053","E02003064","Total",6535,3068,3467,6524,11,19,209.36,31.2
"2011","Bristol 054","E02006887","Total",6634,3696,2938,6025,609,25,194.62,34.1
"2011","Bristol 055","E02006888","Total",6824,3539,3285,6792,32,52,73.74,92.5
"2011","Bristol 056","E02006889","Total",7347,3738,3609,7347,0,22,160.30,45.8
"2011","Bristol 057","E02006890","Total",8568,4313,4255,8561,7,58,101.19,84.7
"2011","Cornwall 010","E02003892","Total",6253,3023,3230,6253,0,118,2344.77,2.7
"2011","Cornwall 012","E02003893","Total",6481,3213,3268,6481,0,96,15193.73,0.4
"2011","Cornwall 013","E02003894","Total",8017,3954,4063,8017,0,70,3519.54,2.3
"2011","Cornwall 016","E02003895","Total",7965,3788,4177,7965,0,95,6657.06,1.2
"2011","Cornwall 017","E02003896","Total",5593,2716,2877,5593,0,65,339.79,16.5
"2011","Cornwall 022","E02003897","Total",5412,2665,2747,5412,0,101,4006.09,1.4
"2011","Cornwall 023","E02003898","Total",6606,3253,3353,6606,0,87,11250.67,0.6
"2011","Cornwall 025","E02003899","Total",5280,2504,2776,5251,29,48,113.97,46.3
"2011","Cornwall 026","E02003900","Total",7163,3501,3662,7163,0,81,308.57,23.2
"2011","Cornwall 028","E02003901","Total",7453,3614,3839,7451,2,89,18003.50,0.4
"2011","Cornwall 029","E02003902","Total",5411,2582,2829,5408,3,50,148.86,36.3
"2011","Cornwall 034","E02003903","Total",6423,3128,3295,6404,19,72,2989.42,2.1
"2011","Cornwall 037","E02003904","Total",5325,2608,2717,5269,56,53,1210.81,4.4
"2011","Cornwall 032","E02003905","Total",6173,3029,3144,6173,0,105,10814.65,0.6
"2011","Cornwall 033","E02003906","Total",5406,2647,2759,5406,0,69,4377.89,1.2
"2011","Cornwall 040","E02003907","Total",7565,3555,4010,7565,0,106,3580.88,2.1
"2011","Cornwall 042","E02003908","Total",7860,3716,4144,7860,0,140,358.18,21.9
"2011","Cornwall 043","E02003909","Total",9113,4349,4764,8989,124,120,1130.02,8.1
"2011","Cornwall 044","E02003910","Total",6068,2871,3197,6059,9,99,329.00,18.4
"2011","Cornwall 047","E02003911","Total",8381,4043,4338,8381,0,144,6629.07,1.3
"2011","Cornwall 048","E02003912","Total",7710,3668,4042,7704,6,134,14084.96,0.5
"2011","Cornwall 056","E02003913","Total",5804,2794,3010,5804,0,95,3679.93,1.6
"2011","Cornwall 060","E02003914","Total",7093,3482,3611,7093,0,59,338.06,21.0
"2011","Cornwall 062","E02003915","Total",7725,3634,4091,7725,0,57,146.95,52.6
"2011","Cornwall 063","E02003916","Total",6616,3158,3458,6614,2,100,221.50,29.9
"2011","Cornwall 064","E02003917","Total",7456,3614,3842,7456,0,82,409.75,18.2
"2011","Cornwall 045","E02003918","Total",6740,3277,3463,6740,0,66,2101.60,3.2
"2011","Cornwall 046","E02003919","Total",6804,3318,3486,6740,64,36,1093.12,6.2
"2011","Cornwall 049","E02003920","Total",7214,3531,3683,7063,151,39,556.96,13.0
"2011","Cornwall 050","E02003921","Total",5821,2756,3065,5816,5,36,1177.22,4.9
"2011","Cornwall 051","E02003922","Total",7721,3826,3895,7686,35,58,1190.89,6.5
"2011","Cornwall 052","E02003923","Total",7204,3531,3673,7141,63,46,250.28,28.8
"2011","Cornwall 053","E02003924","Total",6866,3242,3624,6856,10,53,1553.84,4.4
"2011","Cornwall 055","E02003925","Total",7067,3451,3616,7067,0,48,1006.15,7.0
"2011","Cornwall 059","E02003926","Total",7764,3849,3915,7764,0,104,9507.22,0.8
"2011","Cornwall 066","E02003927","Total",9645,4689,4956,8422,1223,106,7792.85,1.2
"2011","Cornwall 071","E02003928","Total",11682,5635,6047,11633,49,153,1470.75,7.9
"2011","Cornwall 072","E02003929","Total",6585,3191,3394,6585,0,73,4518.99,1.5
"2011","Cornwall 073","E02003930","Total",8917,4702,4215,8150,767,124,15132.54,0.6
"2011","Cornwall 001","E02003931","Total",9934,4797,5137,9716,218,144,1739.24,5.7
"2011","Cornwall 002","E02003932","Total",6945,3438,3507,6797,148,110,21996.15,0.3
"2011","Cornwall 003","E02003933","Total",6881,3324,3557,6750,131,65,11497.07,0.6
"2011","Cornwall 004","E02003934","Total",6669,3260,3409,6571,98,73,18221.46,0.4
"2011","Cornwall 005","E02003935","Total",9216,4452,4764,8977,239,99,881.89,10.5
"2011","Cornwall 006","E02003936","Total",8257,4055,4202,7949,308,130,22908.14,0.4
"2011","Cornwall 007","E02003937","Total",5553,2692,2861,5257,296,89,12887.38,0.4
"2011","Cornwall 008","E02003938","Total",6561,3167,3394,6433,128,62,7723.07,0.8
"2011","Cornwall 009","E02003939","Total",6721,3079,3642,6529,192,96,363.79,18.5
"2011","Cornwall 011","E02003940","Total",6089,2976,3113,5982,107,79,19967.45,0.3
"2011","Cornwall 014","E02003941","Total",7347,3606,3741,7264,83,85,878.60,8.4
"2011","Cornwall 015","E02003942","Total",7389,3536,3853,7211,178,72,461.85,16.0
"2011","Cornwall 054","E02003943","Total",7543,3555,3988,7343,200,75,1002.58,7.5
"2011","Cornwall 057","E02003944","Total",9403,4498,4905,9225,178,72,1332.82,7.1
"2011","Cornwall 058","E02003945","Total",5973,2865,3108,5736,237,105,3645.39,1.6
"2011","Cornwall 061","E02003946","Total",8803,4234,4569,8482,321,98,6295.09,1.4
"2011","Cornwall 065","E02003947","Total",6447,3114,3333,6270,177,92,10764.05,0.6
"2011","Cornwall 067","E02003948","Total",8265,3862,4403,8106,159,89,510.93,16.2
"2011","Cornwall 068","E02003949","Total",6668,3176,3492,6476,192,55,101.78,65.5
"2011","Cornwall 069","E02003950","Total",5375,2640,2735,5223,152,60,6038.35,0.9
"2011","Cornwall 070","E02003951","Total",6112,2943,3169,6027,85,78,678.67,9.0
"2011","Cornwall 018","E02003952","Total",6671,3273,3398,6434,237,69,2869.05,2.3
"2011","Cornwall 019","E02003953","Total",10551,5161,5390,10310,241,112,10172.54,1.0
"2011","Cornwall 020","E02003954","Total",6891,3361,3530,6600,291,79,729.71,9.4
"2011","Cornwall 021","E02003955","Total",9277,4557,4720,9155,122,88,288.84,32.1
"2011","Cornwall 024","E02003956","Total",7050,3474,3576,7013,37,47,6329.79,1.1
"2011","Cornwall 027","E02003957","Total",10100,4998,5102,9930,170,71,7585.98,1.3
"2011","Cornwall 030","E02003958","Total",7827,3820,4007,7815,12,81,3904.71,2.0
"2011","Cornwall 031","E02003959","Total",6873,3327,3546,6718,155,42,691.50,9.9
"2011","Cornwall 035","E02003960","Total",5858,2758,3100,5622,236,87,2790.76,2.1
"2011","Cornwall 036","E02003961","Total",9299,4496,4803,9183,116,108,724.13,12.8
"2011","Cornwall 038","E02003962","Total",6344,3075,3269,6017,327,62,644.15,9.8
"2011","Cornwall 039","E02003963","Total",9287,4419,4868,9058,229,67,278.53,33.3
"2011","Cornwall 041","E02003964","Total",7712,3710,4002,7488,224,88,8173.27,0.9
"2011","Isles of Scilly 001","E02006781","Total",2203,1102,1101,2123,80,79,1637.47,1.3
"2011","North Somerset 001","E02003065","Total",8503,4233,4270,8450,53,102,260.64,32.6
"2011","North Somerset 002","E02003066","Total",6014,2938,3076,5974,40,133,259.62,23.2
"2011","North Somerset 003","E02003067","Total",7526,3621,3905,7494,32,73,345.74,21.8
"2011","North Somerset 004","E02003068","Total",6180,3085,3095,6058,122,93,1808.56,3.4
"2011","North Somerset 005","E02003069","Total",5409,2598,2811,5176,233,100,676.78,8.0
"2011","North Somerset 006","E02003070","Total",12108,6008,6100,12018,90,228,6059.74,2.0
"2011","North Somerset 007","E02003071","Total",7901,3755,4146,7530,371,77,193.82,40.8
"2011","North Somerset 008","E02003072","Total",9045,4346,4699,9045,0,129,946.78,9.6
"2011","North Somerset 009","E02003073","Total",6585,3213,3372,6546,39,163,248.00,26.6
"2011","North Somerset 010","E02003074","Total",7971,3866,4105,7967,4,98,408.27,19.5
"2011","North Somerset 011","E02003075","Total",5788,2816,2972,5747,41,164,2783.78,2.1
"2011","North Somerset 012","E02003076","Total",9273,4568,4705,9177,96,162,3567.31,2.6
"2011","North Somerset 013","E02003077","Total",5975,2901,3074,5974,1,124,5259.34,1.1
"2011","North Somerset 014","E02003078","Total",6877,3263,3614,6717,160,108,3841.21,1.8
"2011","North Somerset 015","E02003079","Total",9599,4683,4916,9599,0,108,194.46,49.4
"2011","North Somerset 016","E02003080","Total",8589,4046,4543,8580,9,84,206.03,41.7
"2011","North Somerset 017","E02003081","Total",9166,4483,4683,9166,0,111,270.84,33.8
"2011","North Somerset 018","E02003082","Total",8583,4204,4379,7985,598,67,311.79,27.5
"2011","North Somerset 020","E02003084","Total",9506,4746,4760,8956,550,55,202.17,47.0
"2011","North Somerset 021","E02003085","Total",7534,3630,3904,7492,42,35,195.70,38.5
"2011","North Somerset 022","E02003086","Total",6053,2893,3160,5665,388,62,189.81,31.9
"2011","North Somerset 023","E02003087","Total",9169,4434,4735,9157,12,108,3252.76,2.8
"2011","North Somerset 024","E02003088","Total",8361,4034,4327,8042,319,179,3860.62,2.2
"2011","North Somerset 025","E02003089","Total",5777,2746,3031,5700,77,58,326.51,17.7
"2011","North Somerset 026","E02006845","Total",7970,3897,4073,7906,64,68,1309.92,6.1
"2011","North Somerset 027","E02006846","Total",7104,3456,3648,7104,0,38,398.40,17.8
"2011","Plymouth 001","E02003122","Total",6729,3213,3516,6644,85,61,361.12,18.6
"2011","Plymouth 002","E02003123","Total",8033,3847,4186,8018,15,34,275.34,29.2
"2011","Plymouth 003","E02003124","Total",7807,3794,4013,7758,49,53,276.59,28.2
"2011","Plymouth 004","E02003125","Total",5995,2937,3058,5971,24,32,327.39,18.3
"2011","Plymouth 005","E02003126","Total",7262,3481,3781,6779,483,56,508.29,14.3
"2011","Plymouth 006","E02003127","Total",7570,3632,3938,7506,64,26,190.87,39.7
"2011","Plymouth 007","E02003128","Total",8654,4132,4522,8553,101,42,207.51,41.7
"2011","Plymouth 008","E02003129","Total",6521,3095,3426,6518,3,73,219.65,29.7
"2011","Plymouth 009","E02003130","Total",10224,5023,5201,10224,0,51,187.52,54.5
"2011","Plymouth 010","E02003131","Total",7499,3572,3927,7499,0,33,271.79,27.6
"2011","Plymouth 011","E02003132","Total",7935,3848,4087,7891,44,67,186.97,42.4
"2011","Plymouth 012","E02003133","Total",7347,3553,3794,7315,32,56,177.69,41.3
"2011","Plymouth 013","E02003134","Total",6930,3395,3535,6921,9,35,193.11,35.9
"2011","Plymouth 014","E02003135","Total",7479,3675,3804,7264,215,36,262.91,28.4
"2011","Plymouth 015","E02003136","Total",7905,3718,4187,7655,250,85,423.25,18.7
"2011","Plymouth 016","E02003137","Total",7794,3788,4006,7613,181,153,195.08,40.0
"2011","Plymouth 017","E02003138","Total",7476,3631,3845,7445,31,83,138.07,54.1
"2011","Plymouth 018","E02003139","Total",6506,3224,3282,6506,0,43,128.64,50.6
"2011","Plymouth 019","E02003140","Total",7697,3704,3993,7582,115,64,368.07,20.9
"2011","Plymouth 020","E02003141","Total",8014,4106,3908,7819,195,66,82.62,97.0
"2011","Plymouth 021","E02003142","Total",9084,4403,4681,9014,70,37,236.34,38.4
"2011","Plymouth 022","E02003143","Total",7791,3745,4046,7718,73,69,191.09,40.8
"2011","Plymouth 023","E02003144","Total",9041,4949,4092,8293,748,76,89.99,100.5
"2011","Plymouth 024","E02003145","Total",6976,3523,3453,6674,302,86,121.32,57.5
"2011","Plymouth 025","E02003146","Total",9018,4644,4374,8801,217,71,82.91,108.8
"2011","Plymouth 026","E02003147","Total",7645,3917,3728,7575,70,41,209.20,36.5
"2011","Plymouth 027","E02003148","Total",9886,5244,4642,8485,1401,64,153.18,64.5
"2011","Plymouth 028","E02003149","Total",9340,4850,4490,9213,127,58,195.32,47.8
"2011","Plymouth 029","E02003150","Total",11468,6144,5324,11277,191,60,226.67,50.6
"2011","Plymouth 030","E02003151","Total",7449,3511,3938,7333,116,93,468.37,15.9
"2011","Plymouth 031","E02003152","Total",9426,4586,4840,9363,63,95,786.32,12.0
"2011","Plymouth 032","E02003153","Total",7883,3800,4083,7873,10,79,240.17,32.8
"2011","Poole 001","E02003194","Total",6241,3023,3218,5795,446,134,1430.67,4.4
"2011","Poole 002","E02003195","Total",5612,2760,2852,5510,102,50,310.32,18.1
"2011","Poole 003","E02003196","Total",10303,4919,5384,10206,97,237,613.18,16.8
"2011","Poole 004","E02003197","Total",6815,3324,3491,6815,0,104,319.79,21.3
"2011","Poole 005","E02003198","Total",7264,3527,3737,7205,59,45,191.85,37.9
"2011","Poole 006","E02003199","Total",9180,4433,4747,9167,13,70,367.89,25.0
"2011","Poole 007","E02003200","Total",9962,4883,5079,9937,25,74,266.23,37.4
"2011","Poole 008","E02003201","Total",10573,5252,5321,10563,10,79,246.21,42.9
"2011","Poole 009","E02003202","Total",6206,3089,3117,5863,343,60,250.11,24.8
"2011","Poole 010","E02003203","Total",7415,3672,3743,7409,6,71,132.14,56.1
"2011","Poole 011","E02003204","Total",8690,4135,4555,8536,154,85,234.31,37.1
"2011","Poole 012","E02003205","Total",8238,4042,4196,8234,4,111,213.66,38.6
"2011","Poole 013","E02003206","Total",9596,4777,4819,9441,155,163,248.99,38.5
"2011","Poole 014","E02003207","Total",7099,3533,3566,7041,58,53,327.39,21.7
"2011","Poole 015","E02003208","Total",10683,5123,5560,10121,562,80,285.98,37.4
"2011","Poole 016","E02003209","Total",6042,2987,3055,5994,48,30,213.02,28.4
"2011","Poole 017","E02003210","Total",9106,4450,4656,9030,76,111,311.12,29.3
"2011","Poole 018","E02003211","Total",8620,4192,4428,8236,384,161,512.47,16.8
"2011","South Gloucestershire 001","E02003090","Total",6918,3272,3646,6548,370,136,2139.12,3.2
"2011","South Gloucestershire 002","E02003091","Total",6573,3288,3285,6573,0,113,1393.34,4.7
"2011","South Gloucestershire 003","E02003092","Total",7915,4180,3735,7342,573,145,5663.42,1.4
"2011","South Gloucestershire 004","E02003093","Total",6581,3241,3340,6514,67,148,7390.05,0.9
"2011","South Gloucestershire 005","E02003094","Total",8352,4159,4193,8299,53,109,4446.01,1.9
"2011","South Gloucestershire 006","E02003095","Total",7123,3508,3615,6947,176,79,514.44,13.8
"2011","South Gloucestershire 007","E02003096","Total",6453,3172,3281,6451,2,62,127.05,50.8
"2011","South Gloucestershire 008","E02003097","Total",6220,3015,3205,6155,65,67,506.21,12.3
"2011","South Gloucestershire 009","E02003098","Total",10038,5061,4977,10021,17,93,277.69,36.1
"2011","South Gloucestershire 010","E02003099","Total",6825,3368,3457,6770,55,56,196.79,34.7
"2011","South Gloucestershire 011","E02003100","Total",10511,5239,5272,10494,17,60,433.83,24.2
"2011","South Gloucestershire 012","E02003101","Total",10561,5319,5242,10560,1,119,174.68,60.5
"2011","South Gloucestershire 013","E02003102","Total",6520,3258,3262,6495,25,88,844.87,7.7
"2011","South Gloucestershire 014","E02003103","Total",7216,3584,3632,7198,18,45,136.40,52.9
"2011","South Gloucestershire 015","E02003104","Total",7654,3781,3873,7654,0,78,181.25,42.2
"2011","South Gloucestershire 016","E02003105","Total",6298,3034,3264,6207,91,82,753.15,8.4
"2011","South Gloucestershire 017","E02003106","Total",10507,5450,5057,8577,1930,184,1006.15,10.4
"2011","South Gloucestershire 018","E02003107","Total",10607,5445,5162,10531,76,89,406.75,26.1
"2011","South Gloucestershire 019","E02003108","Total",9307,4685,4622,9144,163,94,3178.39,2.9
"2011","South Gloucestershire 020","E02003109","Total",5985,2929,3056,5985,0,81,148.86,40.2
"2011","South Gloucestershire 021","E02003110","Total",10369,5171,5198,10360,9,166,341.45,30.4
"2011","South Gloucestershire 022","E02003111","Total",6294,3060,3234,6206,88,73,150.23,41.9
"2011","South Gloucestershire 023","E02003112","Total",6381,3150,3231,6381,0,41,117.78,54.2
"2011","South Gloucestershire 024","E02003113","Total",10167,5035,5132,10117,50,231,17027.36,0.6
"2011","South Gloucestershire 025","E02003114","Total",6988,3423,3565,6956,32,45,136.42,51.2
"2011","South Gloucestershire 026","E02003115","Total",9159,4499,4660,9000,159,40,153.64,59.6
"2011","South Gloucestershire 027","E02003116","Total",7557,3615,3942,7482,75,36,138.38,54.6
"2011","South Gloucestershire 028","E02003117","Total",8582,4229,4353,8462,120,42,168.35,51.0
"2011","South Gloucestershire 029","E02003118","Total",10199,5046,5153,10091,108,64,349.94,29.1
"2011","South Gloucestershire 030","E02003119","Total",10344,5090,5254,10259,85,69,394.25,26.2
"2011","South Gloucestershire 031","E02003120","Total",8393,4097,4296,8333,60,82,319.22,26.3
"2011","South Gloucestershire 032","E02003121","Total",10170,5021,5149,10095,75,131,479.09,21.2
"2011","Swindon 001","E02003212","Total",8259,4005,4254,8212,47,106,3117.81,2.6
"2011","Swindon 003","E02003214","Total",6328,3033,3295,6328,0,16,143.80,44.0
"2011","Swindon 004","E02003215","Total",6993,3432,3561,6960,33,65,146.11,47.9
"2011","Swindon 005","E02003216","Total",9095,4456,4639,9070,25,82,309.58,29.4
"2011","Swindon 006","E02003217","Total",6515,3229,3286,6487,28,35,126.91,51.3
"2011","Swindon 007","E02003218","Total",6575,3187,3388,6566,9,47,141.93,46.3
"2011","Swindon 008","E02003219","Total",6686,3324,3362,6462,224,159,9765.68,0.7
"2011","Swindon 009","E02003220","Total",10274,5037,5237,10082,192,104,554.56,18.5
"2011","Swindon 010","E02003221","Total",6450,3289,3161,6448,2,39,200.42,32.2
"2011","Swindon 011","E02003222","Total",6306,3127,3179,6306,0,110,164.98,38.2
"2011","Swindon 012","E02003223","Total",9672,4994,4678,9672,0,53,481.01,20.1
"2011","Swindon 013","E02003224","Total",8742,4328,4414,8742,0,76,190.88,45.8
"2011","Swindon 014","E02003225","Total",5956,3007,2949,5954,2,101,288.24,20.7
"2011","Swindon 015","E02003226","Total",8352,4622,3730,8313,39,47,94.34,88.5
"2011","Swindon 016","E02003227","Total",6339,3127,3212,6328,11,29,115.78,54.8
"2011","Swindon 017","E02003228","Total",6590,3297,3293,6585,5,62,184.81,35.7
"2011","Swindon 018","E02003229","Total",5661,2792,2869,5661,0,111,181.51,31.2
"2011","Swindon 019","E02003230","Total",7273,3966,3307,7088,185,49,99.28,73.3
"2011","Swindon 020","E02003231","Total",8514,4119,4395,8452,62,48,139.09,61.2
"2011","Swindon 021","E02003232","Total",8145,4239,3906,7882,263,135,222.94,36.5
"2011","Swindon 022","E02003233","Total",8859,4439,4420,8859,0,67,270.17,32.8
"2011","Swindon 023","E02003234","Total",8684,4279,4405,8655,29,82,294.30,29.5
"2011","Swindon 024","E02003235","Total",7302,3579,3723,7276,26,115,551.20,13.2
"2011","Swindon 025","E02003236","Total",10512,5096,5416,10396,116,160,4569.15,2.3
"2011","Swindon 026","E02006847","Total",9257,4659,4598,9257,0,65,264.18,35.0
"2011","Swindon 027","E02006848","Total",6789,3431,3358,6789,0,50,110.66,61.4
"2011","Swindon 028","E02006849","Total",9028,4525,4503,9028,0,85,281.04,32.1
"2011","Torbay 001","E02003154","Total",7178,3413,3765,7154,24,60,196.42,36.5
"2011","Torbay 002","E02003155","Total",5822,2782,3040,5585,237,58,432.81,13.5
"2011","Torbay 003","E02003156","Total",9525,4581,4944,9380,145,124,415.54,22.9
"2011","Torbay 004","E02003157","Total",6223,3109,3114,6088,135,52,159.98,38.9
"2011","Torbay 005","E02003158","Total",5440,2542,2898,5287,153,42,117.25,46.4
"2011","Torbay 006","E02003159","Total",5747,2785,2962,5624,123,59,73.91,77.8
"2011","Torbay 008","E02003161","Total",6897,3600,3297,6461,436,42,146.18,47.2
"2011","Torbay 010","E02003163","Total",7777,3826,3951,7369,408,99,404.93,19.2
"2011","Torbay 011","E02003164","Total",8826,4188,4638,8634,192,101,273.82,32.2
"2011","Torbay 012","E02003165","Total",7133,3425,3708,7020,113,58,142.55,50.0
"2011","Torbay 013","E02003166","Total",10477,5096,5381,10475,2,75,1102.68,9.5
"2011","Torbay 014","E02003167","Total",9018,4286,4732,8432,586,46,174.94,51.5
"2011","Torbay 015","E02003168","Total",6910,3242,3668,6866,44,64,305.46,22.6
"2011","Torbay 016","E02003169","Total",6657,3181,3476,6593,64,114,988.69,6.7
"2011","Torbay 017","E02003170","Total",9331,4444,4887,9216,115,76,330.65,28.2
"2011","Torbay 018","E02003171","Total",7362,3524,3838,7252,110,48,290.18,25.4
"2011","Torbay 019","E02006840","Total",10636,5086,5550,10472,164,147,731.41,14.5
"2011","Wiltshire 012","E02006634","Total",8635,4239,4396,8484,151,280,23486.73,0.4
"2011","Wiltshire 019","E02006635","Total",8395,4039,4356,7561,834,178,604.60,13.9
"2011","Wiltshire 024","E02006636","Total",6860,3306,3554,6804,56,205,12671.68,0.5
"2011","Wiltshire 025","E02006637","Total",10743,5190,5553,10604,139,151,962.66,11.2
"2011","Wiltshire 026","E02006638","Total",6262,3023,3239,6241,21,108,415.96,15.1
"2011","Wiltshire 028","E02006639","Total",8494,4320,4174,8066,428,210,8730.52,1.0
"2011","Wiltshire 029","E02006640","Total",7069,3503,3566,7013,56,230,20031.82,0.4
"2011","Wiltshire 034","E02006641","Total",7416,3620,3796,6988,428,205,11461.53,0.6
"2011","Wiltshire 038","E02006642","Total",5768,2832,2936,5714,54,175,15328.93,0.4
"2011","Wiltshire 041","E02006643","Total",15048,8767,6281,12151,2897,190,2967.67,5.1
"2011","Wiltshire 001","E02006644","Total",6744,3314,3430,6694,50,165,5866.35,1.1
"2011","Wiltshire 002","E02006645","Total",7157,3560,3597,7104,53,165,4075.97,1.8
"2011","Wiltshire 003","E02006646","Total",5601,2719,2882,5447,154,125,3713.77,1.5
"2011","Wiltshire 004","E02006647","Total",5897,2956,2941,5884,13,180,10776.10,0.5
"2011","Wiltshire 005","E02006648","Total",5855,2849,3006,5788,67,170,8879.29,0.7
"2011","Wiltshire 006","E02006649","Total",6864,3382,3482,6759,105,131,186.66,36.8
"2011","Wiltshire 007","E02006650","Total",11290,5729,5561,10739,551,231,7655.31,1.5
"2011","Wiltshire 008","E02006651","Total",7234,3658,3576,6945,289,184,11415.95,0.6
"2011","Wiltshire 009","E02006652","Total",9541,4689,4852,9422,119,147,304.89,31.3
"2011","Wiltshire 010","E02006653","Total",9829,4843,4986,9795,34,180,246.16,39.9
"2011","Wiltshire 011","E02006654","Total",9353,4570,4783,9150,203,106,349.87,26.7
"2011","Wiltshire 013","E02006655","Total",7002,3422,3580,6853,149,173,14645.47,0.5
"2011","Wiltshire 014","E02006656","Total",7077,3560,3517,7062,15,173,445.04,15.9
"2011","Wiltshire 015","E02006657","Total",10126,4855,5271,9782,344,106,279.62,36.2
"2011","Wiltshire 016","E02006658","Total",7148,3472,3676,7111,37,94,275.02,26.0
"2011","Wiltshire 017","E02006659","Total",7648,3885,3763,7312,336,172,3654.26,2.1
"2011","Wiltshire 018","E02006660","Total",13012,6248,6764,12726,286,252,3998.03,3.3
"2011","Wiltshire 045","E02006661","Total",9193,5220,3973,7596,1597,235,12636.29,0.7
"2011","Wiltshire 046","E02006662","Total",5917,2950,2967,5898,19,74,581.40,10.2
"2011","Wiltshire 048","E02006663","Total",10724,5250,5474,10535,189,152,2402.24,4.5
"2011","Wiltshire 049","E02006664","Total",6526,3211,3315,6384,142,169,11395.15,0.6
"2011","Wiltshire 050","E02006665","Total",6560,3185,3375,6454,106,220,13781.69,0.5
"2011","Wiltshire 051","E02006666","Total",5645,2667,2978,5566,79,140,242.50,23.3
"2011","Wiltshire 052","E02006667","Total",6369,3065,3304,6369,0,57,340.90,18.7
"2011","Wiltshire 053","E02006668","Total",6104,2965,3139,5937,167,129,516.32,11.8
"2011","Wiltshire 054","E02006669","Total",9710,4623,5087,9699,11,316,22630.24,0.4
"2011","Wiltshire 055","E02006670","Total",6712,3343,3369,6575,137,65,214.92,31.2
"2011","Wiltshire 056","E02006671","Total",6137,2912,3225,5738,399,124,191.39,32.1
"2011","Wiltshire 057","E02006672","Total",6652,3122,3530,6497,155,164,6814.01,1.0
"2011","Wiltshire 058","E02006673","Total",5003,2356,2647,4922,81,95,204.40,24.5
"2011","Wiltshire 059","E02006674","Total",5712,2674,3038,5569,143,120,212.71,26.9
"2011","Wiltshire 060","E02006675","Total",7909,3789,4120,7901,8,244,9171.49,0.9
"2011","Wiltshire 061","E02006676","Total",6119,2869,3250,5827,292,193,12458.46,0.5
"2011","Wiltshire 062","E02006677","Total",7792,3772,4020,7662,130,151,6618.45,1.2
"2011","Wiltshire 020","E02006678","Total",7344,3625,3719,7344,0,56,218.30,33.6
"2011","Wiltshire 021","E02006679","Total",9744,4773,4971,9519,225,161,4745.41,2.1
"2011","Wiltshire 022","E02006680","Total",7333,3599,3734,7239,94,88,236.21,31.0
"2011","Wiltshire 023","E02006681","Total",5936,2838,3098,5827,109,161,3987.98,1.5
"2011","Wiltshire 027","E02006682","Total",9402,4431,4971,9385,17,184,867.07,10.8
"2011","Wiltshire 030","E02006683","Total",7765,3817,3948,7715,50,109,1363.69,5.7
"2011","Wiltshire 031","E02006684","Total",6166,3060,3106,6098,68,45,221.99,27.8
"2011","Wiltshire 032","E02006685","Total",7699,3718,3981,7558,141,94,254.74,30.2
"2011","Wiltshire 033","E02006686","Total",5481,2652,2829,5358,123,86,194.81,28.1
"2011","Wiltshire 035","E02006687","Total",7289,3578,3711,7289,0,76,156.38,46.6
"2011","Wiltshire 036","E02006688","Total",5669,2787,2882,5655,14,50,126.76,44.7
"2011","Wiltshire 037","E02006689","Total",6267,3038,3229,6252,15,95,5462.40,1.1
"2011","Wiltshire 039","E02006690","Total",6716,3291,3425,6716,0,148,8047.50,0.8
"2011","Wiltshire 040","E02006691","Total",13490,6512,6978,13345,145,124,575.07,23.5
"2011","Wiltshire 042","E02006692","Total",5697,2796,2901,5504,193,130,1143.76,5.0
"2011","Wiltshire 043","E02006693","Total",5728,2773,2955,5713,15,87,885.75,6.5
"2011","Wiltshire 044","E02006694","Total",6065,2909,3156,5816,249,91,260.44,23.3
"2011","Wiltshire 047","E02006695","Total",6338,3034,3304,6293,45,241,22943.44,0.3
"2011","East Devon 001","E02004129","Total",5492,2737,2755,5449,43,86,15891.54,0.3
"2011","East Devon 002","E02004130","Total",5919,2773,3146,5881,38,73,561.17,10.5
"2011","East Devon 003","E02004131","Total",5564,2628,2936,5507,57,52,735.47,7.6
"2011","East Devon 004","E02004132","Total",8231,4025,4206,8203,28,155,11044.53,0.7
"2011","East Devon 005","E02004133","Total",8180,3925,4255,8060,120,86,5164.44,1.6
"2011","East Devon 006","E02004134","Total",6883,3360,3523,6793,90,137,10528.60,0.7
"2011","East Devon 007","E02004135","Total",8044,3847,4197,7917,127,160,9615.29,0.8
"2011","East Devon 008","E02004136","Total",7959,3802,4157,7894,65,145,3595.48,2.2
"2011","East Devon 009","E02004137","Total",5339,2559,2780,5272,67,103,9798.46,0.5
"2011","East Devon 010","E02004138","Total",7096,3260,3836,6902,194,66,475.86,14.9
"2011","East Devon 011","E02004139","Total",6372,2947,3425,6353,19,67,649.39,9.8
"2011","East Devon 012","E02004140","Total",5178,2322,2856,4905,273,84,590.10,8.8
"2011","East Devon 013","E02004141","Total",5820,2807,3013,5673,147,219,5539.34,1.1
"2011","East Devon 014","E02004142","Total",5981,3371,2610,5088,893,132,3996.90,1.5
"2011","East Devon 015","E02004143","Total",6320,3008,3312,6233,87,77,302.33,20.9
"2011","East Devon 016","E02004144","Total",6719,3191,3528,6670,49,93,255.57,26.3
"2011","East Devon 017","E02004145","Total",5967,2717,3250,5844,123,71,1367.88,4.4
"2011","East Devon 018","E02004146","Total",7223,3369,3854,7166,57,67,404.83,17.8
"2011","East Devon 019","E02004147","Total",7025,3399,3626,6926,99,63,109.15,64.4
"2011","East Devon 020","E02004148","Total",7145,3274,3871,6792,353,75,808.33,8.8
"2011","Exeter 001","E02004149","Total",9019,4385,4634,6177,2842,158,715.43,12.6
"2011","Exeter 002","E02004150","Total",6825,3352,3473,6816,9,51,298.68,22.9
"2011","Exeter 003","E02004151","Total",7957,3762,4195,7925,32,67,368.84,21.6
"2011","Exeter 004","E02004152","Total",8421,4117,4304,7726,695,106,104.24,80.8
"2011","Exeter 005","E02004153","Total",7546,3704,3842,7522,24,56,334.66,22.5
"2011","Exeter 006","E02004154","Total",8173,4090,4083,7798,375,111,108.32,75.5
"2011","Exeter 007","E02004155","Total",7557,3607,3950,7533,24,83,158.48,47.7
"2011","Exeter 008","E02004156","Total",9584,4902,4682,8615,969,78,191.73,50.0
"2011","Exeter 009","E02004157","Total",6587,3071,3516,6182,405,138,144.82,45.5
"2011","Exeter 010","E02004158","Total",7824,3840,3984,7772,52,91,105.47,74.2
"2011","Exeter 011","E02004159","Total",9307,4606,4701,9232,75,101,716.88,13.0
"2011","Exeter 012","E02004160","Total",7175,3438,3737,7021,154,68,288.43,24.9
"2011","Exeter 013","E02004161","Total",7976,3817,4159,7915,61,52,180.25,44.2
"2011","Exeter 014","E02004162","Total",7231,3521,3710,7007,224,52,504.55,14.3
"2011","Exeter 015","E02004163","Total",6591,2999,3592,6567,24,90,481.99,13.7
"2011","Mid Devon 001","E02004164","Total",6586,3245,3341,6529,57,121,20783.21,0.3
"2011","Mid Devon 002","E02004165","Total",8047,3895,4152,7990,57,141,5576.25,1.4
"2011","Mid Devon 003","E02004166","Total",6487,3194,3293,6476,11,97,8269.11,0.8
"2011","Mid Devon 004","E02004167","Total",7200,3495,3705,6977,223,55,361.92,19.9
"2011","Mid Devon 005","E02004168","Total",6088,3003,3085,6040,48,39,1211.65,5.0
"2011","Mid Devon 006","E02004169","Total",7103,3499,3604,7065,38,121,6710.55,1.1
"2011","Mid Devon 007","E02004170","Total",7643,3716,3927,7522,121,70,381.88,20.0
"2011","Mid Devon 008","E02004171","Total",7562,3663,3899,7492,70,129,12675.96,0.6
"2011","Mid Devon 009","E02004172","Total",6155,3024,3131,6099,56,106,16423.89,0.4
"2011","Mid Devon 010","E02004173","Total",7279,3625,3654,7212,67,139,18459.17,0.4
"2011","Mid Devon 011","E02004174","Total",7600,3711,3889,7464,136,84,439.89,17.3
"2011","North Devon 001","E02004175","Total",5517,2697,2820,5312,205,47,704.12,7.8
"2011","North Devon 002","E02004176","Total",5588,2710,2878,5345,243,71,13915.29,0.4
"2011","North Devon 003","E02004177","Total",5992,2900,3092,5797,195,66,1506.73,4.0
"2011","North Devon 004","E02004178","Total",5471,2687,2784,5342,129,100,6592.12,0.8
"2011","North Devon 005","E02004179","Total",9078,4601,4477,8520,558,139,3614.73,2.5
"2011","North Devon 006","E02004180","Total",5900,2885,3015,5795,105,130,18159.15,0.3
"2011","North Devon 007","E02004181","Total",5849,2804,3045,5794,55,81,299.03,19.6
"2011","North Devon 008","E02004182","Total",6200,3009,3191,6176,24,45,303.91,20.4
"2011","North Devon 009","E02004183","Total",5782,2790,2992,5706,76,60,235.04,24.6
"2011","North Devon 010","E02004184","Total",8614,4104,4510,8552,62,96,235.16,36.6
"2011","North Devon 011","E02004185","Total",5811,2760,3051,5724,87,80,4032.31,1.4
"2011","North Devon 012","E02004186","Total",8224,3971,4253,8201,23,106,6145.58,1.3
"2011","North Devon 013","E02004187","Total",9336,4553,4783,9104,232,138,25410.88,0.4
"2011","North Devon 014","E02004188","Total",6305,3087,3218,6224,81,125,27451.05,0.2
"2011","South Hams 001","E02004189","Total",5925,3021,2904,5663,262,67,8650.84,0.7
"2011","South Hams 002","E02004190","Total",7883,3764,4119,7741,142,151,21492.40,0.4
"2011","South Hams 003","E02004191","Total",8076,3760,4316,8024,52,115,599.13,13.5
"2011","South Hams 004","E02004192","Total",7163,3482,3681,7143,20,129,11205.67,0.6
"2011","South Hams 005","E02004193","Total",11851,5716,6135,11703,148,220,316.84,37.4
"2011","South Hams 006","E02004194","Total",6235,2988,3247,6163,72,123,12096.27,0.5
"2011","South Hams 007","E02004195","Total",5605,2849,2756,5315,290,59,782.31,7.2
"2011","South Hams 008","E02004196","Total",7120,3421,3699,7034,86,185,11778.93,0.6
"2011","South Hams 009","E02004197","Total",6269,3019,3250,6229,40,117,4776.17,1.3
"2011","South Hams 010","E02004198","Total",6423,3024,3399,6341,82,106,1460.72,4.4
"2011","South Hams 011","E02004199","Total",5351,2566,2785,5350,1,77,9778.44,0.5
"2011","South Hams 012","E02004200","Total",5239,2506,2733,5099,140,103,5712.06,0.9
"2011","Teignbridge 001","E02004201","Total",5193,2518,2675,5121,72,109,12714.49,0.4
"2011","Teignbridge 002","E02004202","Total",7759,3754,4005,7677,82,106,7352.84,1.1
"2011","Teignbridge 003","E02004203","Total",5636,2737,2899,5519,117,140,17650.35,0.3
"2011","Teignbridge 004","E02004204","Total",9304,4561,4743,9227,77,146,4373.05,2.1
"2011","Teignbridge 005","E02004205","Total",6450,3090,3360,6301,149,80,1136.88,5.7
"2011","Teignbridge 006","E02004206","Total",6711,3141,3570,6450,261,81,1034.09,6.5
"2011","Teignbridge 007","E02004207","Total",5957,2878,3079,5943,14,86,4390.17,1.4
"2011","Teignbridge 008","E02004208","Total",7969,3861,4108,7724,245,108,469.27,17.0
"2011","Teignbridge 009","E02004209","Total",8306,3998,4308,8253,53,67,378.35,22.0
"2011","Teignbridge 010","E02004210","Total",6780,3157,3623,6526,254,62,137.61,49.3
"2011","Teignbridge 011","E02004211","Total",6499,3099,3400,6363,136,95,3536.79,1.8
"2011","Teignbridge 012","E02004212","Total",5939,2865,3074,5881,58,81,236.01,25.2
"2011","Teignbridge 013","E02004213","Total",5668,3092,2576,4792,876,79,3539.78,1.6
"2011","Teignbridge 014","E02004214","Total",5919,2877,3042,5906,13,46,170.07,34.8
"2011","Teignbridge 015","E02004215","Total",5650,2711,2939,5407,243,80,394.54,14.3
"2011","Teignbridge 016","E02004216","Total",5562,2740,2822,5562,0,84,195.25,28.5
"2011","Teignbridge 017","E02004217","Total",7718,3710,4008,7607,111,105,3925.81,2.0
"2011","Teignbridge 018","E02004218","Total",5679,2762,2917,5659,20,94,1853.98,3.1
"2011","Teignbridge 019","E02004219","Total",5521,2628,2893,5419,102,95,3897.67,1.4
"2011","Torridge 001","E02004220","Total",6184,2968,3216,6145,39,49,611.28,10.1
"2011","Torridge 002","E02004221","Total",5878,2775,3103,5608,270,87,522.90,11.2
"2011","Torridge 003","E02004222","Total",5717,2841,2876,5641,76,55,160.52,35.6
"2011","Torridge 004","E02004223","Total",11348,5522,5826,11259,89,100,3653.09,3.1
"2011","Torridge 005","E02004224","Total",6254,3080,3174,6182,72,103,16072.74,0.4
"2011","Torridge 006","E02004225","Total",5714,2716,2998,5619,95,59,1453.39,3.9
"2011","Torridge 007","E02004226","Total",6916,3451,3465,6852,64,113,23238.51,0.3
"2011","Torridge 008","E02004227","Total",8929,4414,4515,8809,120,113,25291.58,0.4
"2011","Torridge 009","E02004228","Total",6899,3400,3499,6772,127,96,27381.31,0.3
"2011","West Devon 001","E02004229","Total",7963,3973,3990,7798,165,118,26113.04,0.3
"2011","West Devon 002","E02004230","Total",7500,3662,3838,7382,118,80,3807.73,2.0
"2011","West Devon 003","E02004231","Total",6793,3486,3307,6228,565,138,36309.81,0.2
"2011","West Devon 004","E02004232","Total",6529,3208,3321,6418,111,103,26849.28,0.2
"2011","West Devon 005","E02004233","Total",12280,5825,6455,11876,404,233,1329.79,9.2
"2011","West Devon 006","E02004234","Total",6119,2919,3200,5983,136,139,16464.50,0.4
"2011","West Devon 007","E02004235","Total",6369,3050,3319,6229,140,135,5089.41,1.3
"2011","Christchurch 001","E02004236","Total",5773,2806,2967,5723,50,59,3391.22,1.7
"2011","Christchurch 002","E02004237","Total",7783,3791,3992,7688,95,85,267.33,29.1
"2011","Christchurch 003","E02004238","Total",7094,3291,3803,7015,79,76,357.22,19.9
"2011","Christchurch 004","E02004239","Total",5587,2653,2934,5552,35,59,281.74,19.8
"2011","Christchurch 005","E02004240","Total",6077,3008,3069,6072,5,32,164.83,36.9
"2011","Christchurch 006","E02004241","Total",9010,4324,4686,8925,85,75,358.61,25.1
"2011","Christchurch 007","E02004242","Total",6428,3001,3427,6323,105,67,218.01,29.5
"2011","East Dorset 001","E02004243","Total",6465,3196,3269,6403,62,139,11085.17,0.6
"2011","East Dorset 002","E02004244","Total",7221,3452,3769,7207,14,79,637.66,11.3
"2011","East Dorset 003","E02004245","Total",7631,3721,3910,7562,69,86,1114.50,6.8
"2011","East Dorset 004","E02004246","Total",6859,3327,3532,6660,199,104,2480.70,2.8
"2011","East Dorset 005","E02004247","Total",5931,2938,2993,5877,54,146,14298.55,0.4
"2011","East Dorset 006","E02004248","Total",7561,3563,3998,7414,147,52,853.75,8.9
"2011","East Dorset 007","E02004249","Total",5393,2656,2737,5393,0,134,701.23,7.7
"2011","East Dorset 008","E02004250","Total",7643,3611,4032,7547,96,48,382.55,20.0
"2011","East Dorset 009","E02004251","Total",6334,2999,3335,6277,57,82,1007.11,6.3
"2011","East Dorset 010","E02004252","Total",7014,3252,3762,6911,103,68,364.95,19.2
"2011","East Dorset 011","E02004253","Total",8981,4319,4662,8816,165,132,1283.44,7.0
"2011","East Dorset 012","E02004254","Total",10133,4956,5177,10126,7,154,1226.96,8.3
"2011","North Dorset 001","E02004255","Total",7502,3638,3864,7378,124,120,541.08,13.9
"2011","North Dorset 002","E02004256","Total",9204,4543,4661,9027,177,196,10579.96,0.9
"2011","North Dorset 003","E02004257","Total",7314,3488,3826,7139,175,116,449.35,16.3
"2011","North Dorset 004","E02004258","Total",10329,5068,5261,10235,94,198,9221.81,1.1
"2011","North Dorset 005","E02004259","Total",7095,3591,3504,6257,838,191,9920.16,0.7
"2011","North Dorset 006","E02004260","Total",9442,5010,4432,8178,1264,227,12909.20,0.7
"2011","North Dorset 007","E02004261","Total",9983,4982,5001,9834,149,146,349.45,28.6
"2011","North Dorset 008","E02004262","Total",7714,3896,3818,7524,190,191,16950.75,0.5
"2011","Purbeck 001","E02004263","Total",5692,2784,2908,5673,19,127,7273.71,0.8
"2011","Purbeck 002","E02004264","Total",7983,3852,4131,7983,0,93,1448.73,5.5
"2011","Purbeck 003","E02004265","Total",8270,3960,4310,8227,43,116,3612.28,2.3
"2011","Purbeck 004","E02004266","Total",8392,4313,4079,8055,337,129,12571.15,0.7
"2011","Purbeck 005","E02004267","Total",5035,2498,2537,4978,57,120,14414.31,0.3
"2011","Purbeck 006","E02004268","Total",9601,4621,4980,9418,183,155,1121.39,8.6
"2011","West Dorset 001","E02004269","Total",9523,4499,5024,8420,1103,159,668.10,14.3
"2011","West Dorset 002","E02004270","Total",7489,3609,3880,7371,118,213,14924.04,0.5
"2011","West Dorset 003","E02004271","Total",9772,4766,5006,9658,114,187,22035.05,0.4
"2011","West Dorset 004","E02004272","Total",11403,5560,5843,11315,88,219,27291.52,0.4
"2011","West Dorset 005","E02004273","Total",7085,3299,3786,6893,192,126,8026.25,0.9
"2011","West Dorset 006","E02004274","Total",6460,3089,3371,6383,77,76,455.27,14.2
"2011","West Dorset 007","E02004275","Total",7419,3559,3860,7386,33,143,12597.46,0.6
"2011","West Dorset 008","E02004276","Total",5675,2637,3038,5568,107,70,397.74,14.3
"2011","West Dorset 009","E02004277","Total",10290,5000,5290,9739,551,159,443.70,23.2
"2011","West Dorset 010","E02004278","Total",8770,4215,4555,8750,20,177,268.33,32.7
"2011","West Dorset 011","E02004279","Total",7769,3760,4009,7539,230,157,11868.69,0.7
"2011","West Dorset 012","E02004280","Total",7609,3738,3871,7574,35,102,9171.27,0.8
"2011","Weymouth and Portland 001","E02004281","Total",7316,3542,3774,7295,21,72,767.13,9.5
"2011","Weymouth and Portland 002","E02004282","Total",8641,4127,4514,8454,187,125,813.83,10.6
"2011","Weymouth and Portland 003","E02004283","Total",8669,4261,4408,8582,87,102,706.15,12.3
"2011","Weymouth and Portland 004","E02004284","Total",9470,4808,4662,9121,349,87,208.18,45.5
"2011","Weymouth and Portland 005","E02004285","Total",7465,3632,3833,7358,107,64,173.59,43.0
"2011","Weymouth and Portland 006","E02004286","Total",5191,2570,2621,5140,51,73,122.56,42.4
"2011","Weymouth and Portland 007","E02004287","Total",5571,2695,2876,5560,11,68,175.72,31.7
"2011","Weymouth and Portland 008","E02004288","Total",5643,3285,2358,4674,969,42,617.27,9.1
"2011","Weymouth and Portland 009","E02004289","Total",7201,3512,3689,7189,12,58,591.45,12.2
"2011","Cheltenham 001","E02004600","Total",5700,2830,2870,5693,7,55,527.13,10.8
"2011","Cheltenham 002","E02004601","Total",5165,2431,2734,5101,64,95,409.21,12.6
"2011","Cheltenham 003","E02004602","Total",6432,3016,3416,6320,112,34,197.83,32.5
"2011","Cheltenham 004","E02004603","Total",7675,3665,4010,7202,473,95,146.39,52.4
"2011","Cheltenham 005","E02004604","Total",7955,3875,4080,7946,9,54,122.07,65.2
"2011","Cheltenham 006","E02004605","Total",5731,2793,2938,5717,14,47,138.23,41.5
"2011","Cheltenham 007","E02004606","Total",9788,5021,4767,9597,191,88,220.98,44.3
"2011","Cheltenham 008","E02004607","Total",9449,4858,4591,9360,89,106,162.40,58.2
"2011","Cheltenham 009","E02004608","Total",10461,5095,5366,8890,1571,149,216.63,48.3
"2011","Cheltenham 010","E02004609","Total",7276,3641,3635,7251,25,122,315.63,23.1
"2011","Cheltenham 011","E02004610","Total",8036,3883,4153,7339,697,179,208.88,38.5
"2011","Cheltenham 012","E02004611","Total",11088,5317,5771,10937,151,227,1184.43,9.4
"2011","Cheltenham 013","E02004612","Total",9437,4566,4871,9419,18,138,197.59,47.8
"2011","Cheltenham 014","E02004613","Total",6264,2971,3293,6175,89,183,399.10,15.7
"2011","Cheltenham 015","E02004614","Total",5275,2550,2725,5201,74,123,214.87,24.5
"2011","Cotswold 001","E02004615","Total",7929,3780,4149,7833,96,142,10127.05,0.8
"2011","Cotswold 002","E02004616","Total",8652,4096,4556,8540,112,162,10617.59,0.8
"2011","Cotswold 003","E02004617","Total",7679,3699,3980,7607,72,184,15304.40,0.5
"2011","Cotswold 004","E02004618","Total",7297,3650,3647,7099,198,281,25981.48,0.3
"2011","Cotswold 005","E02004619","Total",7293,3543,3750,7218,75,249,23022.06,0.3
"2011","Cotswold 006","E02004620","Total",7686,3774,3912,7685,1,127,661.33,11.6
"2011","Cotswold 007","E02004621","Total",6305,2974,3331,5831,474,101,1264.69,5.0
"2011","Cotswold 008","E02004622","Total",6871,3370,3501,6553,318,91,1488.66,4.6
"2011","Cotswold 009","E02004623","Total",8004,3866,4138,7894,110,190,6550.55,1.2
"2011","Cotswold 010","E02004624","Total",5876,2856,3020,5872,4,144,7106.86,0.8
"2011","Cotswold 011","E02004625","Total",9289,4496,4793,9187,102,210,14327.29,0.6
"2011","Forest of Dean 001","E02004626","Total",9677,4726,4951,8736,941,222,15710.38,0.6
"2011","Forest of Dean 002","E02004627","Total",5350,2593,2757,5276,74,78,2802.24,1.9
"2011","Forest of Dean 003","E02004628","Total",7759,3869,3890,7647,112,65,2486.23,3.1
"2011","Forest of Dean 004","E02004629","Total",12262,6059,6203,12201,61,85,3718.59,3.3
"2011","Forest of Dean 005","E02004630","Total",6556,3246,3310,6307,249,117,8249.75,0.8
"2011","Forest of Dean 006","E02004631","Total",5009,2475,2534,4944,65,96,6525.93,0.8
"2011","Forest of Dean 007","E02004632","Total",10011,4885,5126,9957,54,99,1092.16,9.2
"2011","Forest of Dean 008","E02004633","Total",8168,4021,4147,8144,24,82,3957.88,2.1
"2011","Forest of Dean 009","E02004634","Total",9993,4858,5135,9919,74,103,3530.24,2.8
"2011","Forest of Dean 010","E02004635","Total",7176,3540,3636,6909,267,114,4577.23,1.6
"2011","Gloucester 001","E02004636","Total",8081,4015,4066,7882,199,141,199.71,40.5
"2011","Gloucester 002","E02004637","Total",8862,4441,4421,8361,501,94,297.45,29.8
"2011","Gloucester 003","E02004638","Total",5776,2814,2962,5670,106,86,144.11,40.1
"2011","Gloucester 004","E02004639","Total",8219,4406,3813,7842,377,83,777.39,10.6
"2011","Gloucester 005","E02004640","Total",7846,3935,3911,7828,18,50,97.12,80.8
"2011","Gloucester 006","E02004641","Total",7273,3483,3790,7235,38,88,179.23,40.6
"2011","Gloucester 007","E02004642","Total",11875,5839,6036,11853,22,148,412.28,28.8
"2011","Gloucester 008","E02004643","Total",7817,3817,4000,7771,46,78,115.30,67.8
"2011","Gloucester 009","E02004644","Total",8702,4284,4418,8652,50,77,267.45,32.5
"2011","Gloucester 010","E02004645","Total",9490,4666,4824,9471,19,149,197.50,48.1
"2011","Gloucester 011","E02004646","Total",8500,4183,4317,8436,64,62,454.51,18.7
"2011","Gloucester 012","E02004647","Total",5889,2832,3057,5749,140,65,194.44,30.3
"2011","Gloucester 013","E02004648","Total",5839,2842,2997,5829,10,27,140.83,41.5
"2011","Gloucester 014","E02004649","Total",7098,3419,3679,6990,108,63,227.02,31.3
"2011","Gloucester 015","E02004650","Total",10421,5128,5293,10386,35,109,349.34,29.8
"2011","Stroud 001","E02004651","Total",7628,3762,3866,7586,42,109,5443.61,1.4
"2011","Stroud 002","E02004652","Total",6300,3043,3257,6299,1,189,7575.13,0.8
"2011","Stroud 003","E02004653","Total",6554,3245,3309,6457,97,121,7189.90,0.9
"2011","Stroud 004","E02004654","Total",11229,5526,5703,11159,70,141,619.75,18.1
"2011","Stroud 005","E02004655","Total",7725,3847,3878,7422,303,99,493.78,15.6
"2011","Stroud 006","E02004656","Total",11093,5512,5581,10917,176,149,666.15,16.7
"2011","Stroud 007","E02004657","Total",6870,3439,3431,6858,12,138,842.54,8.2
"2011","Stroud 008","E02004658","Total",6509,3193,3316,6498,11,125,478.91,13.6
"2011","Stroud 009","E02004659","Total",6259,3080,3179,6231,28,130,4297.29,1.5
"2011","Stroud 010","E02004660","Total",6473,3098,3375,6306,167,162,2417.06,2.7
"2011","Stroud 011","E02004661","Total",8162,4035,4127,8162,0,123,1181.88,6.9
"2011","Stroud 012","E02004662","Total",6060,3018,3042,5978,82,93,6684.89,0.9
"2011","Stroud 013","E02004663","Total",6614,3172,3442,6518,96,125,1842.49,3.6
"2011","Stroud 014","E02004664","Total",6697,3305,3392,6605,92,78,462.18,14.5
"2011","Stroud 015","E02004665","Total",8606,4239,4367,8507,99,207,5869.91,1.5
"2011","Tewkesbury 001","E02004666","Total",11583,5849,5734,11464,119,125,2034.97,5.7
"2011","Tewkesbury 002","E02004667","Total",10295,5075,5220,10244,51,121,2337.64,4.4
"2011","Tewkesbury 003","E02004668","Total",8250,4033,4217,8242,8,182,13961.86,0.6
"2011","Tewkesbury 004","E02004669","Total",6603,3228,3375,6516,87,168,10032.87,0.7
"2011","Tewkesbury 005","E02004670","Total",12693,6028,6665,12647,46,204,913.39,13.9
"2011","Tewkesbury 006","E02004671","Total",5863,2888,2975,5802,61,135,5590.69,1.0
"2011","Tewkesbury 007","E02004672","Total",12520,6191,6329,12249,271,219,1158.34,10.8
"2011","Tewkesbury 008","E02004673","Total",5417,2600,2817,5323,94,79,4275.63,1.3
"2011","Tewkesbury 009","E02004674","Total",8719,4188,4531,8566,153,100,1136.44,7.7
"2011","Mendip 001","E02006047","Total",8183,4081,4102,8163,20,172,13580.18,0.6
"2011","Mendip 002","E02006048","Total",6971,3509,3462,6564,407,122,3511.93,2.0
"2011","Mendip 003","E02006049","Total",7418,3603,3815,7323,95,95,220.79,33.6
"2011","Mendip 004","E02006050","Total",8265,4005,4260,8105,160,112,178.46,46.3
"2011","Mendip 005","E02006051","Total",7665,3697,3968,7308,357,203,11013.02,0.7
"2011","Mendip 006","E02006052","Total",7792,3887,3905,7422,370,153,9263.57,0.8
"2011","Mendip 007","E02006053","Total",9187,4469,4718,9053,134,92,367.25,25.0
"2011","Mendip 008","E02006054","Total",7666,3550,4116,7543,123,122,387.50,19.8
"2011","Mendip 009","E02006055","Total",8781,4343,4438,8708,73,78,506.96,17.3
"2011","Mendip 010","E02006056","Total",7358,3597,3761,7200,158,159,13050.65,0.6
"2011","Mendip 011","E02006057","Total",7434,3602,3832,7152,282,121,1750.56,4.2
"2011","Mendip 012","E02006058","Total",8456,4225,4231,7540,916,133,6129.12,1.4
"2011","Mendip 013","E02006059","Total",6479,3193,3286,6408,71,196,13400.48,0.5
"2011","Mendip 014","E02006060","Total",7624,3626,3998,7542,82,77,583.04,13.1
"2011","Sedgemoor 001","E02006061","Total",8899,4281,4618,8753,146,186,4682.29,1.9
"2011","Sedgemoor 002","E02006062","Total",10644,5172,5472,10435,209,140,6294.03,1.7
"2011","Sedgemoor 003","E02006063","Total",7000,3482,3518,6939,61,165,9333.67,0.7
"2011","Sedgemoor 004","E02006064","Total",7807,3658,4149,7489,318,57,202.74,38.5
"2011","Sedgemoor 005","E02006065","Total",8463,4136,4327,8421,42,65,403.43,21.0
"2011","Sedgemoor 006","E02006066","Total",7681,3725,3956,7669,12,80,5009.56,1.5
"2011","Sedgemoor 007","E02006067","Total",6991,3420,3571,6819,172,134,10704.42,0.7
"2011","Sedgemoor 008","E02006068","Total",7579,3761,3818,7518,61,27,249.45,30.4
"2011","Sedgemoor 009","E02006069","Total",9745,4888,4857,9655,90,59,224.78,43.4
"2011","Sedgemoor 010","E02006070","Total",6772,3317,3455,6772,0,48,927.10,7.3
"2011","Sedgemoor 011","E02006071","Total",8473,4108,4365,8312,161,103,1808.56,4.7
"2011","Sedgemoor 012","E02006072","Total",9147,4522,4625,9033,114,179,11323.22,0.8
"2011","Sedgemoor 013","E02006073","Total",7029,3471,3558,6905,124,58,188.70,37.2
"2011","Sedgemoor 014","E02006074","Total",8358,4107,4251,8336,22,123,5084.33,1.6
"2011","South Somerset 001","E02006075","Total",5349,2585,2764,4844,505,227,9666.69,0.6
"2011","South Somerset 002","E02006076","Total",8507,4100,4407,8341,166,207,9352.46,0.9
"2011","South Somerset 003","E02006077","Total",5402,2556,2846,5354,48,89,3800.09,1.4
"2011","South Somerset 004","E02006078","Total",5702,2761,2941,5572,130,102,6543.37,0.9
"2011","South Somerset 005","E02006079","Total",7057,3445,3612,6925,132,139,5598.24,1.3
"2011","South Somerset 006","E02006080","Total",7061,3906,3155,5909,1152,166,7149.12,1.0
"2011","South Somerset 007","E02006081","Total",5299,2558,2741,5278,21,101,7083.98,0.7
"2011","South Somerset 008","E02006082","Total",6467,3171,3296,6450,17,103,4329.75,1.5
"2011","South Somerset 009","E02006083","Total",5724,2784,2940,5677,47,82,2919.40,2.0
"2011","South Somerset 010","E02006084","Total",7077,3382,3695,7044,33,133,5662.24,1.2
"2011","South Somerset 011","E02006085","Total",5875,2859,3016,5875,0,83,291.48,20.2
"2011","South Somerset 012","E02006086","Total",6917,3464,3453,6764,153,107,1047.05,6.6
"2011","South Somerset 013","E02006087","Total",6137,2967,3170,6057,80,53,122.61,50.1
"2011","South Somerset 014","E02006088","Total",7357,3622,3735,7330,27,82,149.92,49.1
"2011","South Somerset 015","E02006089","Total",6392,3234,3158,6203,189,79,181.27,35.3
"2011","South Somerset 016","E02006090","Total",7021,3355,3666,6838,183,74,219.81,31.9
"2011","South Somerset 017","E02006091","Total",9775,4804,4971,9715,60,170,7638.98,1.3
"2011","South Somerset 018","E02006092","Total",6182,3072,3110,6103,79,103,365.38,16.9
"2011","South Somerset 019","E02006093","Total",8445,4077,4368,8331,114,102,4192.22,2.0
"2011","South Somerset 020","E02006094","Total",5310,2613,2697,5300,10,94,4672.19,1.1
"2011","South Somerset 021","E02006095","Total",7826,3748,4078,7782,44,71,1099.61,7.1
"2011","South Somerset 022","E02006096","Total",6704,3289,3415,6650,54,65,448.51,14.9
"2011","South Somerset 023","E02006097","Total",6370,3170,3200,6283,87,54,183.04,34.8
"2011","South Somerset 024","E02006098","Total",7287,3584,3703,7278,9,117,13186.82,0.6
"2011","Taunton Deane 001","E02006099","Total",6829,3276,3553,6765,64,123,6158.74,1.1
"2011","Taunton Deane 002","E02006100","Total",7468,3673,3795,6994,474,154,2176.23,3.4
"2011","Taunton Deane 003","E02006101","Total",5602,2709,2893,5519,83,123,8705.92,0.6
"2011","Taunton Deane 004","E02006102","Total",7141,3370,3771,7125,16,46,154.00,46.4
"2011","Taunton Deane 005","E02006103","Total",7234,3491,3743,7164,70,107,6548.94,1.1
"2011","Taunton Deane 006","E02006104","Total",7544,3613,3931,7452,92,121,1259.74,6.0
"2011","Taunton Deane 007","E02006105","Total",10305,5015,5290,10173,132,124,230.43,44.7
"2011","Taunton Deane 008","E02006106","Total",7704,3943,3761,6900,804,109,1258.55,6.1
"2011","Taunton Deane 009","E02006107","Total",8164,3833,4331,8064,100,62,191.27,42.7
"2011","Taunton Deane 010","E02006108","Total",8561,4161,4400,7898,663,134,304.21,28.1
"2011","Taunton Deane 011","E02006109","Total",7855,3744,4111,7717,138,176,1215.61,6.5
"2011","Taunton Deane 012","E02006110","Total",7892,3798,4094,7730,162,105,434.06,18.2
"2011","Taunton Deane 013","E02006111","Total",10451,5068,5383,10116,335,177,7285.25,1.4
"2011","Taunton Deane 014","E02006112","Total",7437,3586,3851,7235,202,183,10313.34,0.7
"2011","West Somerset 001","E02006113","Total",7327,3413,3914,6927,400,60,328.31,22.3
"2011","West Somerset 002","E02006114","Total",6728,3204,3524,5933,795,63,10075.59,0.7
"2011","West Somerset 003","E02006115","Total",7218,3464,3754,7154,64,78,3988.59,1.8
"2011","West Somerset 004","E02006116","Total",7856,3857,3999,7805,51,167,23979.91,0.3
"2011","West Somerset 005","E02006117","Total",5546,2637,2909,5463,83,79,34162.11,0.2
"2011","Isle of Anglesey 001","W02000001","Total",8632,4288,4344,8597,35,79,13378.97,0.6
"2011","Isle of Anglesey 002","W02000002","Total",6512,3205,3307,6480,32,108,11988.95,0.5
"2011","Isle of Anglesey 003","W02000003","Total",10277,5119,5158,10207,70,71,458.47,22.4
"2011","Isle of Anglesey 004","W02000004","Total",7391,3628,3763,7315,76,67,7459.34,1.0
"2011","Isle of Anglesey 005","W02000005","Total",8803,4250,4553,8666,137,156,8165.21,1.1
"2011","Isle of Anglesey 006","W02000006","Total",6650,3214,3436,6619,31,86,4617.92,1.4
"2011","Isle of Anglesey 007","W02000007","Total",7206,3606,3600,7011,195,66,10071.05,0.7
"2011","Isle of Anglesey 008","W02000008","Total",6483,3138,3345,6340,143,106,716.73,9.0
"2011","Isle of Anglesey 009","W02000009","Total",7797,3826,3971,7706,91,109,14267.47,0.5
"2011","Gwynedd 001","W02000010","Total",9810,4893,4917,7210,2600,155,277.27,35.4
"2011","Gwynedd 002","W02000011","Total",7765,3755,4010,7665,100,112,661.90,11.7
"2011","Gwynedd 003","W02000012","Total",8351,4114,4237,8312,39,108,11349.88,0.7
"2011","Gwynedd 004","W02000013","Total",6590,3266,3324,6499,91,89,3119.16,2.1
"2011","Gwynedd 005","W02000014","Total",6936,3411,3525,6865,71,91,9302.60,0.7
"2011","Gwynedd 006","W02000015","Total",8083,3912,4171,7993,90,108,618.47,13.1
"2011","Gwynedd 007","W02000016","Total",6364,3129,3235,6310,54,88,8218.80,0.8
"2011","Gwynedd 008","W02000017","Total",7671,3735,3936,7629,42,129,11819.17,0.6
"2011","Gwynedd 009","W02000018","Total",6479,3192,3287,6442,37,70,21570.32,0.3
"2011","Gwynedd 010","W02000019","Total",7037,3462,3575,6888,149,108,23334.96,0.3
"2011","Gwynedd 011","W02000020","Total",6870,3323,3547,6813,57,101,13979.51,0.5
"2011","Gwynedd 012","W02000021","Total",7953,3948,4005,7896,57,117,7639.62,1.0
"2011","Gwynedd 013","W02000022","Total",6168,3030,3138,6041,127,72,17884.66,0.3
"2011","Gwynedd 014","W02000023","Total",5922,2957,2965,5898,24,113,16041.40,0.4
"2011","Gwynedd 015","W02000024","Total",5707,2849,2858,5659,48,88,55753.47,0.1
"2011","Gwynedd 016","W02000025","Total",6654,3278,3376,6484,170,99,24695.65,0.3
"2011","Gwynedd 017","W02000026","Total",7514,3652,3862,7370,144,123,27227.10,0.3
"2011","Conwy 001","W02000027","Total",8850,4297,4553,8147,703,80,671.70,13.2
"2011","Conwy 002","W02000028","Total",6968,3233,3735,6881,87,76,488.29,14.3
"2011","Conwy 003","W02000029","Total",6358,3040,3318,6082,276,91,882.69,7.2
"2011","Conwy 004","W02000030","Total",6118,2781,3337,5922,196,91,205.91,29.7
"2011","Conwy 005","W02000031","Total",8460,4058,4402,8340,120,67,1037.07,8.2
"2011","Conwy 006","W02000032","Total",7815,3730,4085,7690,125,115,510.36,15.3
"2011","Conwy 007","W02000033","Total",6698,3379,3319,6429,269,97,191.71,34.9
"2011","Conwy 008","W02000034","Total",7830,3830,4000,7499,331,173,807.27,9.7
"2011","Conwy 009","W02000035","Total",8851,4337,4514,8792,59,117,1250.96,7.1
"2011","Conwy 010","W02000036","Total",10577,5024,5553,10444,133,95,1674.34,6.3
"2011","Conwy 011","W02000037","Total",6962,3384,3578,6955,7,75,2317.83,3.0
"2011","Conwy 012","W02000038","Total",6072,2939,3133,6042,30,91,8188.13,0.7
"2011","Conwy 013","W02000039","Total",7990,3900,4090,7823,167,77,3318.85,2.4
"2011","Conwy 014","W02000040","Total",6881,3467,3414,6795,86,160,46718.84,0.1
"2011","Conwy 015","W02000041","Total",8798,4350,4448,8690,108,115,44318.93,0.2
"2011","Denbighshire 001","W02000042","Total",5716,2746,2970,5706,10,46,186.27,30.7
"2011","Denbighshire 002","W02000043","Total",5358,2556,2802,5317,41,64,635.64,8.4
"2011","Denbighshire 003","W02000044","Total",5197,2470,2727,5172,25,48,210.97,24.6
"2011","Denbighshire 004","W02000045","Total",8603,4407,4196,8530,73,52,278.15,30.9
"2011","Denbighshire 006","W02000047","Total",5383,2591,2792,5383,0,41,183.51,29.3
"2011","Denbighshire 008","W02000049","Total",6496,3180,3316,6449,47,91,5417.51,1.2
"2011","Denbighshire 009","W02000050","Total",6402,3094,3308,6382,20,73,3035.76,2.1
"2011","Denbighshire 010","W02000051","Total",5325,2574,2751,5111,214,87,3197.55,1.7
"2011","Denbighshire 011","W02000052","Total",5287,2664,2623,5122,165,67,1859.89,2.8
"2011","Denbighshire 012","W02000053","Total",6417,3161,3256,6321,96,122,12664.38,0.5
"2011","Denbighshire 013","W02000054","Total",6033,3036,2997,5829,204,144,15983.38,0.4
"2011","Denbighshire 014","W02000055","Total",5461,2661,2800,5282,179,89,817.31,6.7
"2011","Denbighshire 015","W02000056","Total",5227,2627,2600,5219,8,105,18232.83,0.3
"2011","Denbighshire 016","W02000057","Total",6212,3115,3097,6043,169,80,20699.45,0.3
"2011","Denbighshire 017","W02000419","Total",10617,5105,5512,10617,0,102,271.67,39.1
"2011","Flintshire 001","W02000058","Total",5173,2535,2638,5159,14,50,3218.38,1.6
"2011","Flintshire 002","W02000059","Total",6565,3299,3266,6494,71,75,3584.80,1.8
"2011","Flintshire 003","W02000060","Total",10652,5238,5414,10598,54,83,1650.56,6.5
"2011","Flintshire 004","W02000061","Total",6584,3226,3358,6561,23,43,990.23,6.6
"2011","Flintshire 005","W02000062","Total",6369,3141,3228,6255,114,86,901.55,7.1
"2011","Flintshire 006","W02000063","Total",8381,4175,4206,8339,42,145,11459.46,0.7
"2011","Flintshire 007","W02000064","Total",6104,3025,3079,6104,0,31,1016.88,6.0
"2011","Flintshire 008","W02000065","Total",7501,3680,3821,7468,33,69,677.14,11.1
"2011","Flintshire 009","W02000066","Total",9659,4804,4855,9630,29,68,2234.04,4.3
"2011","Flintshire 010","W02000067","Total",6330,3150,3180,6314,16,68,810.16,7.8
"2011","Flintshire 011","W02000068","Total",5605,2858,2747,5605,0,40,854.12,6.6
"2011","Flintshire 012","W02000069","Total",6062,2959,3103,6062,0,95,1490.32,4.1
"2011","Flintshire 013","W02000070","Total",10560,5165,5395,10512,48,170,1119.05,9.4
"2011","Flintshire 014","W02000071","Total",7386,3604,3782,7312,74,95,664.03,11.1
"2011","Flintshire 015","W02000072","Total",11106,5532,5574,11106,0,79,1588.74,7.0
"2011","Flintshire 016","W02000073","Total",10058,4880,5178,9986,72,147,638.03,15.8
"2011","Flintshire 017","W02000074","Total",9336,4576,4760,9254,82,71,563.27,16.6
"2011","Flintshire 018","W02000075","Total",5571,2741,2830,5551,20,95,1779.73,3.1
"2011","Flintshire 019","W02000076","Total",7430,3665,3765,7422,8,120,5171.85,1.4
"2011","Flintshire 020","W02000077","Total",6074,2994,3080,5947,127,89,3341.57,1.8
"2011","Wrexham 003","W02000080","Total",7918,3903,4015,7918,0,62,673.23,11.8
"2011","Wrexham 004","W02000081","Total",5904,2911,2993,5626,278,51,389.37,15.2
"2011","Wrexham 005","W02000082","Total",7454,3663,3791,7419,35,53,469.67,15.9
"2011","Wrexham 006","W02000083","Total",8683,4324,4359,8591,92,67,1237.29,7.0
"2011","Wrexham 007","W02000084","Total",5109,2508,2601,5109,0,54,135.06,37.8
"2011","Wrexham 008","W02000085","Total",9162,4548,4614,8808,354,101,272.87,33.6
"2011","Wrexham 009","W02000086","Total",5115,2449,2666,5105,10,48,156.65,32.7
"2011","Wrexham 010","W02000087","Total",7401,3644,3757,7334,67,25,140.29,52.8
"2011","Wrexham 011","W02000088","Total",8296,4351,3945,8075,221,96,416.68,19.9
"2011","Wrexham 012","W02000089","Total",8372,4288,4084,8313,59,51,210.38,39.8
"2011","Wrexham 013","W02000090","Total",5861,2935,2926,5861,0,63,3410.80,1.7
"2011","Wrexham 014","W02000091","Total",6163,3097,3066,6139,24,63,765.80,8.0
"2011","Wrexham 015","W02000092","Total",7046,3453,3593,6953,93,49,1502.02,4.7
"2011","Wrexham 016","W02000093","Total",6645,3309,3336,6612,33,83,6086.06,1.1
"2011","Wrexham 017","W02000094","Total",9110,4539,4571,9048,62,57,1337.00,6.8
"2011","Wrexham 018","W02000095","Total",6494,3221,3273,6484,10,129,12002.65,0.5
"2011","Wrexham 019","W02000096","Total",6647,3270,3377,6580,67,63,13252.45,0.5
"2011","Wrexham 020","W02000420","Total",13464,6639,6825,13269,195,255,7919.18,1.7
"2011","Powys 001","W02000097","Total",9114,4593,4521,9012,102,163,52937.99,0.2
"2011","Powys 002","W02000098","Total",6299,3107,3192,6295,4,86,12030.07,0.5
"2011","Powys 003","W02000099","Total",6664,3273,3391,6456,208,92,3899.62,1.7
"2011","Powys 004","W02000100","Total",6206,3084,3122,6153,53,84,50951.86,0.1
"2011","Powys 005","W02000101","Total",5485,2716,2769,5461,24,88,12777.19,0.4
"2011","Powys 006","W02000102","Total",6306,3182,3124,6293,13,99,26246.81,0.2
"2011","Powys 007","W02000103","Total",5720,2858,2862,5663,57,107,19005.22,0.3
"2011","Powys 008","W02000104","Total",6180,3062,3118,6109,71,85,2318.51,2.7
"2011","Powys 009","W02000105","Total",5177,2498,2679,5117,60,42,390.08,13.3
"2011","Powys 010","W02000106","Total",6628,3337,3291,6562,66,116,36887.31,0.2
"2011","Powys 011","W02000107","Total",9945,4958,4987,9852,93,158,52701.20,0.2
"2011","Powys 012","W02000108","Total",7062,3468,3594,6952,110,124,43897.06,0.2
"2011","Powys 013","W02000109","Total",5309,2587,2722,5211,98,71,1268.45,4.2
"2011","Powys 014","W02000110","Total",7035,3484,3551,6948,87,117,58201.08,0.1
"2011","Powys 015","W02000111","Total",8430,4156,4274,8293,137,134,32382.86,0.3
"2011","Powys 017","W02000113","Total",8250,3966,4284,7887,363,158,1109.49,7.4
"2011","Powys 018","W02000114","Total",6942,3400,3542,6845,97,163,23835.11,0.3
"2011","Powys 020","W02000414","Total",6014,2981,3033,5930,84,140,70448.70,0.1
"2011","Powys 021","W02000416","Total",10210,4973,5237,10008,202,90,16748.40,0.6
"2011","Ceredigion 001","W02000116","Total",7660,3794,3866,7553,107,153,19374.47,0.4
"2011","Ceredigion 002","W02000117","Total",9998,5266,4732,7721,2277,132,579.01,17.3
"2011","Ceredigion 003","W02000118","Total",7761,3882,3879,6621,1140,106,570.27,13.6
"2011","Ceredigion 005","W02000120","Total",7344,3619,3725,7276,68,124,16143.50,0.5
"2011","Ceredigion 007","W02000122","Total",6722,3347,3375,6701,21,107,16821.61,0.4
"2011","Ceredigion 008","W02000123","Total",8345,4161,4184,7787,558,142,22801.43,0.4
"2011","Ceredigion 009","W02000124","Total",8866,4316,4550,8823,43,110,7688.55,1.2
"2011","Ceredigion 010","W02000125","Total",7504,3664,3840,7402,102,112,17979.03,0.4
"2011","Ceredigion 011","W02000421","Total",11722,5744,5978,11560,162,217,76587.56,0.2
"2011","Pembrokeshire 001","W02000126","Total",8190,4098,4092,8135,55,123,28530.67,0.3
"2011","Pembrokeshire 002","W02000127","Total",9751,4722,5029,9649,102,130,19679.71,0.5
"2011","Pembrokeshire 003","W02000128","Total",7534,3846,3688,7083,451,132,20725.23,0.4
"2011","Pembrokeshire 004","W02000129","Total",6741,3291,3450,6678,63,142,22977.01,0.3
"2011","Pembrokeshire 005","W02000130","Total",6952,3374,3578,6901,51,68,402.47,17.3
"2011","Pembrokeshire 006","W02000131","Total",6958,3291,3667,6896,62,97,991.18,7.0
"2011","Pembrokeshire 007","W02000132","Total",6438,3093,3345,6287,151,113,15502.43,0.4
"2011","Pembrokeshire 008","W02000133","Total",8023,3894,4129,7801,222,147,18451.67,0.4
"2011","Pembrokeshire 009","W02000134","Total",8531,4114,4417,8469,62,116,4762.80,1.8
"2011","Pembrokeshire 010","W02000135","Total",6923,3402,3521,6908,15,76,908.35,7.6
"2011","Pembrokeshire 011","W02000136","Total",8540,4219,4321,8401,139,131,7103.07,1.2
"2011","Pembrokeshire 012","W02000137","Total",6984,3400,3584,6958,26,62,633.02,11.0
"2011","Pembrokeshire 013","W02000138","Total",9753,4841,4912,9672,81,79,631.62,15.4
"2011","Pembrokeshire 014","W02000139","Total",7694,3746,3948,7659,35,121,7885.85,1.0
"2011","Pembrokeshire 015","W02000140","Total",7021,3438,3583,6908,113,100,10007.64,0.7
"2011","Pembrokeshire 016","W02000141","Total",6406,3054,3352,6140,266,91,2681.15,2.4
"2011","Carmarthenshire 001","W02000142","Total",5658,2812,2846,5570,88,61,16059.98,0.4
"2011","Carmarthenshire 002","W02000143","Total",5820,2898,2922,5638,182,112,40630.74,0.1
"2011","Carmarthenshire 003","W02000144","Total",7713,3822,3891,7628,85,111,23167.78,0.3
"2011","Carmarthenshire 004","W02000145","Total",7148,3513,3635,7019,129,137,32012.45,0.2
"2011","Carmarthenshire 005","W02000146","Total",6606,3271,3335,6581,25,133,26099.72,0.3
"2011","Carmarthenshire 006","W02000147","Total",8261,3879,4382,7744,517,109,12822.13,0.6
"2011","Carmarthenshire 007","W02000148","Total",5142,2493,2649,5100,42,74,561.11,9.2
"2011","Carmarthenshire 008","W02000149","Total",6181,2982,3199,6025,156,93,2974.75,2.1
"2011","Carmarthenshire 010","W02000151","Total",7407,3623,3784,7380,27,72,5950.91,1.2
"2011","Carmarthenshire 011","W02000152","Total",8105,3934,4171,7881,224,86,3454.77,2.3
"2011","Carmarthenshire 012","W02000153","Total",7739,3846,3893,7691,48,101,14491.31,0.5
"2011","Carmarthenshire 013","W02000154","Total",7586,3707,3879,7480,106,106,1427.46,5.3
"2011","Carmarthenshire 015","W02000156","Total",8159,4044,4115,8100,59,66,4558.32,1.8
"2011","Carmarthenshire 016","W02000157","Total",8989,4373,4616,8933,56,121,5326.20,1.7
"2011","Carmarthenshire 017","W02000158","Total",5664,2821,2843,5649,15,81,2625.95,2.2
"2011","Carmarthenshire 018","W02000159","Total",6064,2916,3148,6040,24,53,3154.41,1.9
"2011","Carmarthenshire 019","W02000160","Total",7500,3694,3806,7441,59,97,2234.21,3.4
"2011","Carmarthenshire 020","W02000161","Total",5651,2688,2963,5513,138,52,479.85,11.8
"2011","Carmarthenshire 021","W02000162","Total",8547,4164,4383,8508,39,63,4145.80,2.1
"2011","Carmarthenshire 022","W02000163","Total",5457,2618,2839,5396,61,53,159.27,34.3
"2011","Carmarthenshire 023","W02000164","Total",6948,3390,3558,6830,118,86,1479.67,4.7
"2011","Carmarthenshire 024","W02000165","Total",6761,3309,3452,6626,135,53,233.74,28.9
"2011","Carmarthenshire 025","W02000166","Total",8713,4234,4479,8650,63,68,1002.23,8.7
"2011","Carmarthenshire 026","W02000167","Total",9747,4804,4943,9709,38,66,468.04,20.8
"2011","Carmarthenshire 027","W02000418","Total",12211,6002,6209,12095,116,200,31514.66,0.4
"2011","Swansea 001","W02000168","Total",6281,3052,3229,6217,64,54,1558.30,4.0
"2011","Swansea 002","W02000169","Total",9353,4543,4810,9316,37,84,6628.83,1.4
"2011","Swansea 003","W02000170","Total",9111,4431,4680,9073,38,101,513.89,17.7
"2011","Swansea 004","W02000171","Total",7907,3847,4060,7890,17,86,2312.69,3.4
"2011","Swansea 005","W02000172","Total",9824,4832,4992,9700,124,91,1090.51,9.0
"2011","Swansea 006","W02000173","Total",7392,3620,3772,7345,47,70,907.43,8.1
"2011","Swansea 007","W02000174","Total",9134,4449,4685,9105,29,100,747.46,12.2
"2011","Swansea 008","W02000175","Total",7817,3869,3948,7694,123,50,220.73,35.4
"2011","Swansea 009","W02000176","Total",8872,4300,4572,8802,70,46,357.26,24.8
"2011","Swansea 010","W02000177","Total",7041,3428,3613,7032,9,43,650.59,10.8
"2011","Swansea 011","W02000178","Total",8866,4250,4616,8855,11,52,337.97,26.2
"2011","Swansea 012","W02000179","Total",6778,3271,3507,6677,101,89,873.28,7.8
"2011","Swansea 013","W02000180","Total",8086,3900,4186,8059,27,55,337.07,24.0
"2011","Swansea 014","W02000181","Total",6857,3293,3564,6732,125,41,847.36,8.1
"2011","Swansea 015","W02000182","Total",7972,3901,4071,7926,46,68,150.35,53.0
"2011","Swansea 016","W02000183","Total",9241,4670,4571,9155,86,50,287.50,32.1
"2011","Swansea 017","W02000184","Total",6963,3374,3589,6927,36,59,480.87,14.5
"2011","Swansea 018","W02000185","Total",5218,2513,2705,5190,28,95,2254.86,2.3
"2011","Swansea 019","W02000186","Total",8696,4085,4611,8696,0,62,180.81,48.1
"2011","Swansea 020","W02000187","Total",5714,2802,2912,5712,2,76,766.72,7.5
"2011","Swansea 021","W02000188","Total",7187,3617,3570,7187,0,29,599.82,12.0
"2011","Swansea 022","W02000189","Total",7955,3875,4080,7722,233,119,288.08,27.6
"2011","Swansea 023","W02000190","Total",5702,2820,2882,4561,1141,118,322.40,17.7
"2011","Swansea 024","W02000191","Total",9962,5223,4739,9524,438,145,160.21,62.2
"2011","Swansea 025","W02000192","Total",9006,5329,3677,8609,397,76,214.76,41.9
"2011","Swansea 026","W02000193","Total",9507,5157,4350,9396,111,71,105.10,90.5
"2011","Swansea 027","W02000194","Total",6346,3060,3286,5410,936,160,392.21,16.2
"2011","Swansea 028","W02000195","Total",5927,2814,3113,5854,73,127,1048.07,5.7
"2011","Swansea 029","W02000196","Total",6448,3059,3389,6390,58,97,248.50,25.9
"2011","Swansea 030","W02000197","Total",6384,3156,3228,6249,135,108,12649.37,0.5
"2011","Swansea 031","W02000198","Total",7476,3547,3929,7358,118,136,441.42,16.9
"2011","Neath Port Talbot 002","W02000200","Total",5227,2578,2649,5191,36,32,4417.44,1.2
"2011","Neath Port Talbot 003","W02000201","Total",5419,2672,2747,5384,35,42,4084.77,1.3
"2011","Neath Port Talbot 004","W02000202","Total",11601,5700,5901,11454,147,127,5156.54,2.2
"2011","Neath Port Talbot 005","W02000203","Total",6774,3326,3448,6692,82,55,3991.19,1.7
"2011","Neath Port Talbot 006","W02000204","Total",6952,3373,3579,6900,52,109,1063.65,6.5
"2011","Neath Port Talbot 007","W02000205","Total",5961,2903,3058,5927,34,50,800.75,7.4
"2011","Neath Port Talbot 008","W02000206","Total",6785,3347,3438,6673,112,57,211.21,32.1
"2011","Neath Port Talbot 009","W02000207","Total",5200,2511,2689,5135,65,69,1082.71,4.8
"2011","Neath Port Talbot 010","W02000208","Total",9053,4404,4649,8900,153,62,1612.85,5.6
"2011","Neath Port Talbot 011","W02000209","Total",5283,2626,2657,5258,25,22,5595.50,0.9
"2011","Neath Port Talbot 012","W02000210","Total",6493,3196,3297,6474,19,41,274.42,23.7
"2011","Neath Port Talbot 013","W02000211","Total",7951,3882,4069,7921,30,58,923.37,8.6
"2011","Neath Port Talbot 014","W02000212","Total",7690,3763,3927,7653,37,76,4317.04,1.8
"2011","Neath Port Talbot 015","W02000213","Total",6819,3305,3514,6769,50,65,901.86,7.6
"2011","Neath Port Talbot 016","W02000214","Total",9808,4674,5134,9722,86,57,293.15,33.5
"2011","Neath Port Talbot 017","W02000215","Total",9264,4551,4713,9224,40,56,270.87,34.2
"2011","Neath Port Talbot 018","W02000216","Total",7073,3539,3534,7009,64,64,868.74,8.1
"2011","Neath Port Talbot 019","W02000217","Total",6384,3117,3267,6383,1,66,4987.58,1.3
"2011","Neath Port Talbot 020","W02000417","Total",10075,4983,5092,10013,62,84,3272.31,3.1
"2011","Bridgend 001","W02000218","Total",6995,3439,3556,6995,0,28,1456.44,4.8
"2011","Bridgend 002","W02000219","Total",7415,3618,3797,7413,2,65,629.43,11.8
"2011","Bridgend 003","W02000220","Total",7954,3872,4082,7954,0,42,3846.96,2.1
"2011","Bridgend 004","W02000221","Total",7784,3869,3915,7784,0,62,3089.87,2.5
"2011","Bridgend 005","W02000222","Total",6202,3068,3134,6201,1,57,1986.03,3.1
"2011","Bridgend 006","W02000223","Total",5406,2654,2752,5357,49,46,1419.09,3.8
"2011","Bridgend 007","W02000224","Total",6014,2959,3055,6014,0,43,1033.62,5.8
"2011","Bridgend 008","W02000225","Total",8886,4378,4508,8872,14,67,1070.74,8.3
"2011","Bridgend 009","W02000226","Total",10054,5050,5004,10023,31,83,2397.03,4.2
"2011","Bridgend 010","W02000227","Total",7059,3412,3647,6992,67,56,1661.31,4.2
"2011","Bridgend 011","W02000228","Total",6961,4066,2895,5528,1433,85,753.01,9.2
"2011","Bridgend 012","W02000229","Total",6135,2991,3144,6107,28,73,212.14,28.9
"2011","Bridgend 013","W02000230","Total",5453,2655,2798,5288,165,109,2736.50,2.0
"2011","Bridgend 014","W02000231","Total",8169,4083,4086,8137,32,76,237.85,34.3
"2011","Bridgend 015","W02000232","Total",6005,2924,3081,5918,87,85,787.55,7.6
"2011","Bridgend 016","W02000233","Total",6226,3043,3183,6185,41,92,139.49,44.6
"2011","Bridgend 017","W02000234","Total",10455,5078,5377,10412,43,174,278.89,37.5
"2011","Bridgend 018","W02000235","Total",9009,4261,4748,8801,208,159,701.17,12.8
"2011","Bridgend 019","W02000236","Total",6996,3369,3627,6861,135,99,637.62,11.0
"2011","The Vale of Glamorgan 001","W02000237","Total",5281,2613,2668,5281,0,166,6944.93,0.8
"2011","The Vale of Glamorgan 002","W02000238","Total",6180,3004,3176,6132,48,181,4304.58,1.4
"2011","The Vale of Glamorgan 003","W02000239","Total",6679,3272,3407,6631,48,168,10819.29,0.6
"2011","The Vale of Glamorgan 004","W02000240","Total",8714,4161,4553,8646,68,114,336.78,25.9
"2011","The Vale of Glamorgan 005","W02000241","Total",9858,4868,4990,9541,317,186,218.01,45.2
"2011","The Vale of Glamorgan 006","W02000242","Total",7799,3722,4077,7751,48,117,1959.82,4.0
"2011","The Vale of Glamorgan 007","W02000243","Total",9153,4284,4869,9097,56,71,261.26,35.0
"2011","The Vale of Glamorgan 008","W02000244","Total",10031,4799,5232,9965,66,192,1026.86,9.8
"2011","The Vale of Glamorgan 009","W02000245","Total",8543,4211,4332,8527,16,67,295.16,28.9
"2011","The Vale of Glamorgan 010","W02000246","Total",5477,2623,2854,5477,0,95,439.47,12.5
"2011","The Vale of Glamorgan 011","W02000247","Total",8936,4265,4671,8597,339,147,2467.45,3.6
"2011","The Vale of Glamorgan 012","W02000248","Total",10843,5304,5539,10822,21,57,157.97,68.6
"2011","The Vale of Glamorgan 013","W02000249","Total",9010,4309,4701,8733,277,79,151.93,59.3
"2011","The Vale of Glamorgan 014","W02000250","Total",11356,5983,5373,10635,721,113,3162.98,3.6
"2011","The Vale of Glamorgan 015","W02000251","Total",8476,4104,4372,8424,52,104,548.79,15.4
"2011","Cardiff 001","W02000367","Total",6068,2925,3143,5965,103,165,863.53,7.0
"2011","Cardiff 002","W02000368","Total",5946,2845,3101,5946,0,129,128.56,46.3
"2011","Cardiff 003","W02000369","Total",7968,3838,4130,7968,0,103,805.04,9.9
"2011","Cardiff 004","W02000370","Total",6509,3030,3479,6509,0,99,508.05,12.8
"2011","Cardiff 005","W02000371","Total",9110,4391,4719,9033,77,117,274.12,33.2
"2011","Cardiff 006","W02000372","Total",7613,3740,3873,7575,38,202,695.38,10.9
"2011","Cardiff 007","W02000373","Total",6541,3063,3478,6541,0,42,145.72,44.9
"2011","Cardiff 008","W02000374","Total",5683,2705,2978,5683,0,142,204.36,27.8
"2011","Cardiff 009","W02000375","Total",7062,3338,3724,6954,108,53,211.83,33.3
"2011","Cardiff 010","W02000376","Total",6780,3309,3471,6692,88,76,658.27,10.3
"2011","Cardiff 011","W02000377","Total",7125,3380,3745,7045,80,62,767.23,9.3
"2011","Cardiff 012","W02000378","Total",7384,3595,3789,7377,7,103,166.92,44.2
"2011","Cardiff 013","W02000379","Total",6270,2827,3443,6270,0,26,108.14,58.0
"2011","Cardiff 014","W02000380","Total",7108,3431,3677,6999,109,216,2659.68,2.7
"2011","Cardiff 015","W02000381","Total",6271,3054,3217,6271,0,19,210.45,29.8
"2011","Cardiff 016","W02000382","Total",5738,2689,3049,5616,122,15,122.91,46.7
"2011","Cardiff 017","W02000383","Total",7219,3480,3739,7219,0,44,124.08,58.2
"2011","Cardiff 018","W02000384","Total",5753,2864,2889,5636,117,113,197.69,29.1
"2011","Cardiff 019","W02000385","Total",6818,3332,3486,6039,779,203,199.18,34.2
"2011","Cardiff 020","W02000386","Total",7748,3705,4043,7740,8,157,174.37,44.4
"2011","Cardiff 021","W02000387","Total",5962,2852,3110,5725,237,83,108.68,54.9
"2011","Cardiff 022","W02000388","Total",5888,2799,3089,5842,46,48,269.47,21.9
"2011","Cardiff 023","W02000389","Total",8344,4001,4343,8317,27,56,199.00,41.9
"2011","Cardiff 024","W02000390","Total",6335,2945,3390,5634,701,140,173.64,36.5
"2011","Cardiff 025","W02000391","Total",8790,4058,4732,6459,2331,107,126.98,69.2
"2011","Cardiff 026","W02000392","Total",8997,4309,4688,8555,442,230,255.42,35.2
"2011","Cardiff 027","W02000393","Total",6342,3059,3283,6335,7,41,156.03,40.6
"2011","Cardiff 028","W02000394","Total",8922,4416,4506,8324,598,58,98.44,90.6
"2011","Cardiff 029","W02000395","Total",6322,3084,3238,6219,103,86,161.35,39.2
"2011","Cardiff 030","W02000396","Total",8079,4147,3932,7891,188,86,70.73,114.2
"2011","Cardiff 031","W02000397","Total",6639,3147,3492,6639,0,58,150.09,44.2
"2011","Cardiff 032","W02000398","Total",11199,5814,5385,9198,2001,118,235.97,47.5
"2011","Cardiff 033","W02000399","Total",10087,5571,4516,9770,317,76,92.16,109.5
"2011","Cardiff 034","W02000400","Total",6531,3265,3266,6337,194,68,190.08,34.4
"2011","Cardiff 035","W02000401","Total",5947,2893,3054,5933,14,92,89.44,66.5
"2011","Cardiff 036","W02000402","Total",10371,5592,4779,8653,1718,77,106.68,97.2
"2011","Cardiff 037","W02000403","Total",7213,3489,3724,7213,0,45,314.21,23.0
"2011","Cardiff 038","W02000404","Total",6048,2972,3076,5997,51,31,174.21,34.7
"2011","Cardiff 039","W02000405","Total",7507,3484,4023,7507,0,29,125.45,59.8
"2011","Cardiff 040","W02000406","Total",8357,4114,4243,8227,130,56,218.95,38.2
"2011","Cardiff 041","W02000407","Total",6406,2977,3429,6299,107,18,180.87,35.4
"2011","Cardiff 042","W02000408","Total",7240,3950,3290,7136,104,40,68.50,105.7
"2011","Cardiff 043","W02000409","Total",5886,2778,3108,5886,0,33,153.48,38.4
"2011","Cardiff 044","W02000410","Total",8423,4367,4056,8133,290,42,74.66,112.8
"2011","Cardiff 045","W02000411","Total",6454,3106,3348,6386,68,22,151.09,42.7
"2011","Cardiff 046","W02000412","Total",6816,3409,3407,6775,41,37,186.14,36.6
"2011","Cardiff 048","W02000422","Total",6043,3342,2701,6043,0,24,498.39,12.1
"2011","Cardiff 049","W02000423","Total",8228,4412,3816,8040,188,30,182.58,45.1
"2011","Rhondda Cynon Taf 001","W02000252","Total",8947,4344,4603,8936,11,64,8183.34,1.1
"2011","Rhondda Cynon Taf 002","W02000253","Total",6279,3039,3240,6138,141,57,1048.16,6.0
"2011","Rhondda Cynon Taf 003","W02000254","Total",7728,3740,3988,7632,96,79,1297.68,6.0
"2011","Rhondda Cynon Taf 004","W02000255","Total",6202,2997,3205,6156,46,49,1115.63,5.6
"2011","Rhondda Cynon Taf 005","W02000256","Total",9865,4845,5020,9798,67,65,1685.57,5.9
"2011","Rhondda Cynon Taf 006","W02000257","Total",7374,3510,3864,7289,85,60,1200.87,6.1
"2011","Rhondda Cynon Taf 007","W02000258","Total",5727,2801,2926,5679,48,33,2151.68,2.7
"2011","Rhondda Cynon Taf 008","W02000259","Total",5789,2809,2980,5746,43,23,213.32,27.1
"2011","Rhondda Cynon Taf 009","W02000260","Total",5878,2877,3001,5847,31,21,1339.48,4.4
"2011","Rhondda Cynon Taf 010","W02000261","Total",7694,3752,3942,7581,113,74,1332.26,5.8
"2011","Rhondda Cynon Taf 011","W02000262","Total",5232,2529,2703,5205,27,33,579.24,9.0
"2011","Rhondda Cynon Taf 012","W02000263","Total",6390,3146,3244,6377,13,41,915.78,7.0
"2011","Rhondda Cynon Taf 013","W02000264","Total",6006,2942,3064,5989,17,24,692.14,8.7
"2011","Rhondda Cynon Taf 014","W02000265","Total",9192,4478,4714,9024,168,60,1033.39,8.9
"2011","Rhondda Cynon Taf 015","W02000266","Total",7523,3671,3852,7523,0,71,2164.52,3.5
"2011","Rhondda Cynon Taf 016","W02000267","Total",6549,3256,3293,6510,39,34,822.08,8.0
"2011","Rhondda Cynon Taf 017","W02000268","Total",9156,4507,4649,9060,96,66,973.73,9.4
"2011","Rhondda Cynon Taf 018","W02000269","Total",8503,4199,4304,8430,73,47,711.59,11.9
"2011","Rhondda Cynon Taf 019","W02000270","Total",6609,3205,3404,6536,73,52,641.21,10.3
"2011","Rhondda Cynon Taf 020","W02000271","Total",5639,2747,2892,5607,32,36,353.32,16.0
"2011","Rhondda Cynon Taf 021","W02000272","Total",9983,4879,5104,9846,137,81,1234.84,8.1
"2011","Rhondda Cynon Taf 022","W02000273","Total",9915,5114,4801,9226,689,106,737.30,13.4
"2011","Rhondda Cynon Taf 023","W02000274","Total",9810,4792,5018,9703,107,65,1578.10,6.2
"2011","Rhondda Cynon Taf 024","W02000275","Total",5927,2870,3057,5882,45,44,1481.07,4.0
"2011","Rhondda Cynon Taf 025","W02000276","Total",5766,2790,2976,5749,17,47,668.07,8.6
"2011","Rhondda Cynon Taf 026","W02000277","Total",7000,3424,3576,6891,109,57,1135.74,6.2
"2011","Rhondda Cynon Taf 027","W02000278","Total",9402,4614,4788,9342,60,123,1093.36,8.6
"2011","Rhondda Cynon Taf 028","W02000279","Total",7703,3756,3947,7660,43,55,599.33,12.9
"2011","Rhondda Cynon Taf 029","W02000280","Total",8012,3934,4078,8012,0,103,2343.09,3.4
"2011","Rhondda Cynon Taf 030","W02000281","Total",7610,3728,3882,7526,84,83,1180.83,6.4
"2011","Rhondda Cynon Taf 031","W02000282","Total",11000,5340,5660,10985,15,128,1906.25,5.8
"2011","Merthyr Tydfil 002","W02000284","Total",9748,4805,4943,9724,24,61,1140.76,8.5
"2011","Merthyr Tydfil 003","W02000285","Total",8363,4083,4280,8232,131,102,1024.01,8.2
"2011","Merthyr Tydfil 004","W02000286","Total",6574,3241,3333,6500,74,33,323.87,20.3
"2011","Merthyr Tydfil 005","W02000287","Total",8141,4039,4102,8127,14,77,871.64,9.3
"2011","Merthyr Tydfil 006","W02000288","Total",8340,4094,4246,8199,141,62,4122.50,2.0
"2011","Merthyr Tydfil 007","W02000289","Total",8241,4063,4178,8187,54,89,986.22,8.4
"2011","Merthyr Tydfil 008","W02000415","Total",9395,4466,4929,9365,30,50,2670.29,3.5
"2011","Caerphilly 001","W02000290","Total",8845,4314,4531,8779,66,68,2158.10,4.1
"2011","Caerphilly 002","W02000291","Total",7573,3746,3827,7512,61,40,2931.18,2.6
"2011","Caerphilly 003","W02000292","Total",5704,2817,2887,5667,37,33,441.78,12.9
"2011","Caerphilly 004","W02000293","Total",6196,3064,3132,6149,47,31,272.71,22.7
"2011","Caerphilly 005","W02000294","Total",5715,2823,2892,5683,32,49,1856.50,3.1
"2011","Caerphilly 006","W02000295","Total",9429,4673,4756,9344,85,76,1545.53,6.1
"2011","Caerphilly 007","W02000296","Total",7742,3766,3976,7697,45,53,300.67,25.7
"2011","Caerphilly 008","W02000297","Total",7817,3830,3987,7806,11,55,1205.79,6.5
"2011","Caerphilly 009","W02000298","Total",7319,3557,3762,7270,49,50,364.79,20.1
"2011","Caerphilly 010","W02000299","Total",6509,3201,3308,6413,96,55,1036.51,6.3
"2011","Caerphilly 011","W02000300","Total",8552,4230,4322,8493,59,56,575.10,14.9
"2011","Caerphilly 012","W02000301","Total",7790,3818,3972,7705,85,61,959.26,8.1
"2011","Caerphilly 013","W02000302","Total",9690,4712,4978,9629,61,102,1724.71,5.6
"2011","Caerphilly 014","W02000303","Total",6998,3476,3522,6995,3,51,1857.12,3.8
"2011","Caerphilly 015","W02000304","Total",5567,2731,2836,5485,82,43,1784.86,3.1
"2011","Caerphilly 016","W02000305","Total",6464,3167,3297,6464,0,51,274.70,23.5
"2011","Caerphilly 017","W02000306","Total",5229,2521,2708,5194,35,35,513.88,10.2
"2011","Caerphilly 018","W02000307","Total",6799,3377,3422,6778,21,54,1331.50,5.1
"2011","Caerphilly 019","W02000308","Total",9292,4577,4715,9279,13,83,761.35,12.2
"2011","Caerphilly 020","W02000309","Total",6859,3343,3516,6818,41,61,1109.23,6.2
"2011","Caerphilly 021","W02000310","Total",5455,2696,2759,5450,5,85,3269.61,1.7
"2011","Caerphilly 022","W02000311","Total",9505,4558,4947,9502,3,64,317.54,29.9
"2011","Caerphilly 023","W02000312","Total",7500,3663,3837,7478,22,66,242.43,30.9
"2011","Caerphilly 024","W02000313","Total",10257,5041,5216,10165,92,114,910.17,11.3
"2011","Blaenau Gwent 001","W02000314","Total",7100,3483,3617,7028,72,45,826.09,8.6
"2011","Blaenau Gwent 002","W02000315","Total",5530,2741,2789,5402,128,58,582.30,9.5
"2011","Blaenau Gwent 003","W02000316","Total",7125,3469,3656,7098,27,50,1749.68,4.1
"2011","Blaenau Gwent 004","W02000317","Total",7671,3689,3982,7640,31,63,516.60,14.8
"2011","Blaenau Gwent 005","W02000318","Total",9443,4677,4766,9410,33,62,1528.93,6.2
"2011","Blaenau Gwent 006","W02000319","Total",7978,3848,4130,7900,78,68,1417.88,5.6
"2011","Blaenau Gwent 007","W02000320","Total",8569,4263,4306,8465,104,78,1639.91,5.2
"2011","Blaenau Gwent 008","W02000321","Total",9119,4485,4634,9029,90,53,1447.92,6.3
"2011","Blaenau Gwent 009","W02000322","Total",7279,3670,3609,7267,12,44,1166.85,6.2
"2011","Torfaen 001","W02000323","Total",6055,2978,3077,6026,29,29,1782.98,3.4
"2011","Torfaen 002","W02000324","Total",7064,3425,3639,7029,35,48,2476.25,2.9
"2011","Torfaen 003","W02000325","Total",7210,3545,3665,7144,66,38,576.10,12.5
"2011","Torfaen 004","W02000326","Total",9008,4406,4602,8896,112,53,1955.02,4.6
"2011","Torfaen 005","W02000327","Total",5986,2918,3068,5961,25,56,1144.39,5.2
"2011","Torfaen 006","W02000328","Total",7217,3570,3647,7119,98,74,322.30,22.4
"2011","Torfaen 007","W02000329","Total",7505,3704,3801,7469,36,70,606.93,12.4
"2011","Torfaen 008","W02000330","Total",7259,3448,3811,7259,0,80,419.62,17.3
"2011","Torfaen 009","W02000331","Total",6767,3222,3545,6737,30,38,153.26,44.2
"2011","Torfaen 010","W02000332","Total",6822,3303,3519,6746,76,29,330.17,20.7
"2011","Torfaen 011","W02000333","Total",6558,3168,3390,6482,76,81,399.53,16.4
"2011","Torfaen 012","W02000334","Total",6791,3382,3409,6791,0,101,1297.27,5.2
"2011","Torfaen 013","W02000335","Total",6833,3313,3520,6701,132,95,1100.26,6.2
"2011","Monmouthshire 001","W02000336","Total",8148,3893,4255,7997,151,152,14492.88,0.6
"2011","Monmouthshire 002","W02000337","Total",7506,3633,3873,7483,23,70,241.10,31.1
"2011","Monmouthshire 003","W02000338","Total",7665,3735,3930,7562,103,135,5614.98,1.4
"2011","Monmouthshire 004","W02000339","Total",10508,5100,5408,10104,404,240,2783.61,3.8
"2011","Monmouthshire 005","W02000340","Total",7220,3574,3646,7078,142,160,25573.80,0.3
"2011","Monmouthshire 006","W02000341","Total",8387,4309,4078,7922,465,175,13104.58,0.6
"2011","Monmouthshire 007","W02000342","Total",9673,4761,4912,9505,168,260,13035.22,0.7
"2011","Monmouthshire 008","W02000343","Total",8534,4127,4407,8482,52,104,387.55,22.0
"2011","Monmouthshire 009","W02000344","Total",7565,3824,3741,7497,68,184,6955.52,1.1
"2011","Monmouthshire 010","W02000345","Total",8164,4024,4140,8120,44,77,346.41,23.6
"2011","Monmouthshire 011","W02000346","Total",7953,3942,4011,7944,9,125,2379.29,3.3
"2011","Newport 001","W02000347","Total",8061,3914,4147,7925,136,183,1394.24,5.8
"2011","Newport 002","W02000348","Total",7997,3850,4147,7925,72,66,207.10,38.6
"2011","Newport 003","W02000349","Total",7606,3644,3962,7556,50,26,513.66,14.8
"2011","Newport 004","W02000350","Total",7386,3630,3756,7320,66,111,7021.56,1.1
"2011","Newport 005","W02000351","Total",6072,2980,3092,6072,0,52,133.41,45.5
"2011","Newport 006","W02000352","Total",6598,3203,3395,6562,36,49,200.30,32.9
"2011","Newport 007","W02000353","Total",7066,3514,3552,7059,7,72,160.48,44.0
"2011","Newport 008","W02000354","Total",5982,2827,3155,5918,64,49,148.01,40.4
"2011","Newport 009","W02000355","Total",8434,4159,4275,8380,54,147,783.26,10.8
"2011","Newport 010","W02000356","Total",5389,2593,2796,5389,0,20,165.03,32.7
"2011","Newport 011","W02000357","Total",7899,3977,3922,7841,58,41,101.84,77.6
"2011","Newport 012","W02000358","Total",5951,2911,3040,5867,84,119,318.81,18.7
"2011","Newport 013","W02000359","Total",9855,4986,4869,9792,63,49,160.19,61.5
"2011","Newport 014","W02000360","Total",6141,3204,2937,5969,172,59,159.41,38.5
"2011","Newport 015","W02000361","Total",10686,5121,5565,10086,600,91,1506.41,7.1
"2011","Newport 016","W02000362","Total",5986,2894,3092,5981,5,114,364.72,16.4
"2011","Newport 017","W02000363","Total",5657,2715,2942,5580,77,39,220.06,25.7
"2011","Newport 018","W02000364","Total",7318,3691,3627,7272,46,67,552.76,13.2
"2011","Newport 019","W02000365","Total",7485,3519,3966,7485,0,39,239.35,31.3
"2011","Newport 020","W02000366","Total",8167,4048,4119,8124,43,116,4701.00,1.7
